region,day,time,onV,offV,totalV
0,1,0,64,42,106
1,1,0,13,26,39
2,1,0,44,28,72
3,1,0,46,73,119
4,1,0,19,31,50
5,1,0,91,98,189
6,1,0,12,19,31
7,1,0,14,26,40
8,1,0,31,38,69
9,1,0,15,46,61
10,1,0,54,87,141
11,1,0,13,17,30
12,1,0,15,29,44
13,1,0,57,48,105
14,1,0,60,61,121
15,1,0,32,13,45
16,1,0,55,57,112
17,1,0,70,56,126
18,1,0,34,46,80
19,1,0,30,27,57
20,1,0,27,25,52
21,1,0,30,18,48
22,1,0,1,9,10
23,1,0,25,46,71
24,1,0,70,93,163
25,1,0,33,55,88
26,1,0,108,70,178
27,1,0,16,18,34
28,1,0,35,66,101
29,1,0,32,70,102
30,1,0,17,27,44
31,1,0,17,23,40
32,1,0,91,91,182
33,1,0,62,63,125
34,1,0,11,12,23
35,1,0,53,37,90
36,1,0,34,73,107
37,1,0,3,11,14
38,1,0,2,0,2
39,1,0,16,21,37
40,1,0,14,12,26
41,1,0,7,18,25
42,1,0,42,53,95
43,1,0,26,28,54
44,1,0,2,5,7
45,1,0,20,19,39
46,1,0,23,35,58
47,1,0,3,6,9
48,1,0,48,30,78
49,1,0,29,64,93
50,1,0,7,13,20
51,1,0,64,72,136
52,1,0,38,46,84
53,1,0,0,1,1
54,1,0,12,6,18
55,1,0,66,47,113
56,1,0,12,10,22
57,1,0,25,36,61
58,1,0,39,42,81
59,1,0,66,69,135
60,1,0,34,25,59
61,1,0,32,34,66
62,1,0,11,14,25
63,1,0,48,37,85
64,1,0,30,31,61
65,1,0,39,38,77
66,1,0,10,7,17
67,1,0,15,25,40
68,1,0,42,56,98
69,1,0,46,33,79
70,1,0,27,20,47
71,1,0,44,53,97
72,1,0,4,4,8
73,1,0,49,31,80
74,1,0,25,22,47
75,1,0,53,35,88
76,1,0,30,18,48
77,1,0,19,37,56
78,1,0,12,13,25
79,1,0,7,7,14
80,1,0,31,18,49
81,1,0,41,30,71
82,1,0,26,17,43
83,1,0,21,36,57
84,1,0,8,2,10
85,1,0,66,75,141
86,1,0,8,6,14
87,1,0,166,110,276
88,1,0,12,19,31
89,1,0,29,8,37
90,1,0,24,19,43
91,1,0,77,46,123
92,1,0,3,30,33
93,1,0,13,18,31
94,1,0,8,6,14
95,1,0,0,4,4
96,1,0,20,14,34
97,1,0,28,27,55
98,1,0,5,11,16
99,1,0,37,29,66
100,1,0,45,40,85
101,1,0,81,59,140
102,1,0,17,9,26
103,1,0,54,64,118
104,1,0,14,23,37
105,1,0,22,22,44
106,1,0,21,48,69
107,1,0,87,30,117
108,1,0,31,36,67
109,1,0,20,24,44
110,1,0,28,14,42
111,1,0,104,68,172
112,1,0,9,20,29
113,1,0,4,14,18
114,1,0,73,75,148
115,1,0,38,53,91
116,1,0,11,20,31
117,1,0,16,43,59
118,1,0,46,45,91
119,1,0,76,85,161
120,1,0,26,20,46
121,1,0,19,8,27
122,1,0,14,12,26
123,1,0,36,66,102
124,1,0,0,1,1
125,1,0,18,11,29
126,1,0,14,14,28
127,1,0,23,15,38
128,1,0,7,10,17
129,1,0,53,47,100
130,1,0,38,56,94
131,1,0,37,44,81
132,1,0,13,17,30
133,1,0,6,15,21
134,1,0,56,44,100
135,1,0,30,41,71
136,1,0,19,21,40
137,1,0,3,6,9
138,1,0,11,18,29
139,1,0,10,10,20
140,1,0,47,62,109
141,1,0,66,80,146
142,1,0,9,7,16
143,1,0,6,16,22
144,1,0,7,8,15
145,1,0,38,46,84
146,1,0,8,23,31
147,1,0,10,24,34
148,1,0,1,1,2
149,1,0,22,45,67
150,1,0,23,13,36
151,1,0,37,25,62
152,1,0,10,10,20
153,1,0,0,1,1
154,1,0,76,75,151
155,1,0,22,28,50
156,1,0,7,19,26
157,1,0,6,9,15
158,1,0,19,11,30
159,1,0,19,21,40
160,1,0,8,17,25
161,1,0,25,27,52
162,1,0,1,1,2
163,1,0,9,17,26
164,1,0,8,17,25
165,1,0,0,0,0
166,1,0,93,14,107
167,1,0,6,7,13
168,1,0,2,7,9
169,1,0,13,24,37
170,1,0,56,58,114
171,1,0,3,6,9
172,1,0,3,6,9
173,1,0,55,44,99
174,1,0,23,20,43
175,1,0,19,11,30
176,1,0,0,4,4
177,1,0,30,35,65
178,1,0,5,2,7
179,1,0,8,12,20
180,1,0,25,13,38
181,1,0,20,34,54
182,1,0,7,11,18
183,1,0,47,47,94
184,1,0,46,24,70
185,1,0,14,14,28
186,1,0,49,48,97
187,1,0,187,91,278
188,1,0,69,63,132
189,1,0,0,0,0
190,1,0,10,33,43
191,1,0,11,16,27
192,1,0,16,7,23
193,1,0,12,19,31
194,1,0,45,28,73
195,1,0,19,47,66
196,1,0,24,8,32
197,1,0,4,14,18
198,1,0,27,6,33
199,1,0,0,0,0
200,1,0,4,32,36
201,1,0,32,25,57
202,1,0,0,0,0
203,1,0,51,60,111
204,1,0,118,114,232
205,1,0,8,9,17
206,1,0,1,6,7
207,1,0,35,64,99
208,1,0,1,1,2
209,1,0,89,57,146
210,1,0,1,0,1
211,1,0,73,55,128
212,1,0,0,0,0
213,1,0,23,6,29
214,1,0,18,8,26
215,1,0,41,36,77
216,1,0,0,0,0
217,1,0,3,5,8
218,1,0,5,2,7
219,1,0,19,19,38
220,1,0,0,0,0
221,1,0,98,133,231
222,1,0,156,150,306
223,1,0,45,7,52
224,1,0,6,4,10
225,1,0,1,0,1
226,1,0,63,88,151
227,1,0,0,4,4
228,1,0,8,12,20
229,1,0,8,10,18
230,1,0,17,25,42
231,1,0,42,52,94
232,1,0,10,14,24
233,1,0,89,109,198
234,1,0,21,16,37
235,1,0,0,3,3
236,1,0,22,18,40
237,1,0,23,15,38
238,1,0,5,9,14
239,1,0,18,5,23
240,1,0,32,16,48
241,1,0,13,5,18
242,1,0,22,10,32
243,1,0,24,70,94
244,1,0,48,59,107
245,1,0,26,20,46
246,1,0,21,7,28
247,1,0,35,14,49
248,1,0,48,40,88
249,1,0,48,31,79
250,1,0,14,14,28
251,1,0,3,10,13
252,1,0,8,14,22
253,1,0,59,26,85
254,1,0,17,12,29
255,1,0,16,11,27
256,1,0,18,14,32
257,1,0,39,54,93
258,1,0,1,1,2
259,1,0,50,91,141
260,1,0,7,11,18
261,1,0,1,6,7
262,1,0,6,23,29
263,1,0,45,15,60
264,1,0,1,2,3
265,1,0,2,4,6
266,1,0,7,6,13
267,1,0,2,1,3
268,1,0,9,5,14
269,1,0,9,4,13
270,1,0,0,0,0
271,1,0,7,6,13
272,1,0,21,32,53
273,1,0,48,42,90
274,1,0,30,35,65
275,1,0,26,15,41
276,1,0,6,11,17
277,1,0,45,40,85
278,1,0,6,4,10
279,1,0,56,13,69
280,1,0,4,14,18
281,1,0,4,1,5
282,1,0,0,2,2
283,1,0,38,58,96
284,1,0,36,43,79
285,1,0,2,1,3
286,1,0,11,9,20
287,1,0,19,6,25
288,1,0,0,2,2
289,1,0,42,13,55
290,1,0,0,0,0
291,1,0,16,26,42
292,1,0,1,5,6
293,1,0,0,1,1
294,1,0,26,34,60
295,1,0,18,12,30
296,1,0,48,34,82
297,1,0,32,11,43
298,1,0,35,27,62
299,1,0,41,21,62
300,1,0,13,17,30
301,1,0,9,6,15
302,1,0,18,11,29
303,1,0,12,17,29
304,1,0,0,0,0
305,1,0,23,42,65
306,1,0,18,10,28
307,1,0,0,3,3
308,1,0,15,11,26
309,1,0,17,12,29
310,1,0,52,23,75
311,1,0,36,34,70
312,1,0,21,20,41
313,1,0,11,10,21
314,1,0,0,0,0
315,1,0,114,139,253
316,1,0,16,21,37
317,1,0,10,13,23
318,1,0,10,22,32
319,1,0,0,1,1
320,1,0,16,16,32
321,1,0,3,2,5
322,1,0,12,8,20
323,1,0,0,0,0
324,1,0,16,9,25
325,1,0,25,17,42
326,1,0,7,4,11
327,1,0,18,9,27
328,1,0,20,23,43
329,1,0,33,15,48
330,1,0,18,20,38
331,1,0,44,78,122
332,1,0,2,15,17
333,1,0,19,17,36
334,1,0,47,40,87
335,1,0,44,61,105
336,1,0,20,14,34
337,1,0,10,11,21
338,1,0,23,25,48
339,1,0,5,13,18
340,1,0,4,7,11
341,1,0,11,7,18
342,1,0,31,15,46
343,1,0,2,3,5
344,1,0,31,28,59
345,1,0,73,33,106
346,1,0,21,28,49
347,1,0,23,5,28
348,1,0,33,17,50
349,1,0,19,32,51
350,1,0,6,21,27
351,1,0,6,18,24
352,1,0,8,22,30
353,1,0,25,22,47
354,1,0,5,14,19
355,1,0,13,20,33
356,1,0,55,25,80
357,1,0,0,4,4
358,1,0,21,26,47
359,1,0,29,17,46
360,1,0,25,59,84
361,1,0,15,13,28
362,1,0,76,31,107
363,1,0,5,11,16
364,1,0,29,29,58
365,1,0,34,25,59
366,1,0,13,15,28
367,1,0,74,43,117
368,1,0,10,9,19
369,1,0,13,11,24
370,1,0,2,9,11
371,1,0,30,31,61
372,1,0,16,12,28
373,1,0,12,21,33
374,1,0,24,19,43
375,1,0,23,23,46
376,1,0,65,41,106
377,1,0,86,64,150
378,1,0,11,6,17
379,1,0,17,22,39
380,1,0,29,17,46
381,1,0,1,8,9
382,1,0,22,37,59
383,1,0,12,7,19
384,1,0,61,37,98
385,1,0,5,10,15
386,1,0,46,28,74
387,1,0,15,10,25
388,1,0,9,10,19
389,1,0,0,0,0
390,1,0,164,77,241
391,1,0,2,5,7
392,1,0,5,16,21
393,1,0,49,44,93
394,1,0,12,29,41
395,1,0,12,17,29
396,1,0,6,3,9
397,1,0,3,2,5
398,1,0,8,18,26
399,1,0,2,8,10
400,1,0,0,2,2
401,1,0,4,4,8
402,1,0,8,21,29
403,1,0,14,28,42
404,1,0,0,0,0
405,1,0,133,162,295
406,1,0,37,46,83
407,1,0,4,10,14
408,1,0,36,46,82
409,1,0,7,13,20
410,1,0,23,51,74
411,1,0,50,50,100
412,1,0,0,3,3
413,1,0,8,8,16
414,1,0,4,14,18
415,1,0,10,31,41
416,1,0,27,40,67
417,1,0,2,10,12
418,1,0,29,25,54
419,1,0,30,33,63
420,1,0,84,26,110
421,1,0,57,59,116
422,1,0,26,47,73
423,1,0,3,8,11
424,1,0,0,1,1
0,1,3,38,37,75
1,1,3,11,31,42
2,1,3,35,20,55
3,1,3,27,62,89
4,1,3,16,18,34
5,1,3,48,62,110
6,1,3,10,11,21
7,1,3,24,25,49
8,1,3,25,30,55
9,1,3,15,28,43
10,1,3,41,62,103
11,1,3,17,17,34
12,1,3,8,15,23
13,1,3,48,32,80
14,1,3,48,49,97
15,1,3,23,10,33
16,1,3,58,45,103
17,1,3,87,53,140
18,1,3,20,32,52
19,1,3,16,13,29
20,1,3,22,31,53
21,1,3,24,16,40
22,1,3,3,2,5
23,1,3,17,34,51
24,1,3,54,63,117
25,1,3,18,38,56
26,1,3,68,32,100
27,1,3,9,16,25
28,1,3,41,54,95
29,1,3,20,53,73
30,1,3,24,26,50
31,1,3,15,22,37
32,1,3,56,42,98
33,1,3,29,42,71
34,1,3,3,6,9
35,1,3,38,29,67
36,1,3,28,54,82
37,1,3,5,5,10
38,1,3,0,3,3
39,1,3,10,16,26
40,1,3,8,12,20
41,1,3,3,7,10
42,1,3,22,50,72
43,1,3,12,21,33
44,1,3,6,5,11
45,1,3,16,15,31
46,1,3,12,26,38
47,1,3,4,4,8
48,1,3,39,19,58
49,1,3,21,41,62
50,1,3,2,14,16
51,1,3,17,25,42
52,1,3,35,34,69
53,1,3,0,0,0
54,1,3,23,24,47
55,1,3,38,37,75
56,1,3,3,7,10
57,1,3,27,39,66
58,1,3,36,38,74
59,1,3,58,65,123
60,1,3,28,32,60
61,1,3,18,29,47
62,1,3,14,22,36
63,1,3,45,32,77
64,1,3,18,29,47
65,1,3,36,16,52
66,1,3,8,5,13
67,1,3,15,18,33
68,1,3,36,48,84
69,1,3,21,20,41
70,1,3,24,8,32
71,1,3,39,52,91
72,1,3,2,1,3
73,1,3,29,20,49
74,1,3,12,10,22
75,1,3,30,24,54
76,1,3,12,14,26
77,1,3,9,19,28
78,1,3,12,12,24
79,1,3,5,6,11
80,1,3,19,14,33
81,1,3,58,20,78
82,1,3,11,22,33
83,1,3,27,26,53
84,1,3,7,4,11
85,1,3,73,69,142
86,1,3,10,5,15
87,1,3,160,95,255
88,1,3,6,12,18
89,1,3,13,6,19
90,1,3,11,9,20
91,1,3,42,31,73
92,1,3,2,21,23
93,1,3,5,17,22
94,1,3,1,3,4
95,1,3,0,4,4
96,1,3,13,10,23
97,1,3,11,18,29
98,1,3,3,3,6
99,1,3,46,25,71
100,1,3,30,36,66
101,1,3,56,70,126
102,1,3,5,9,14
103,1,3,55,47,102
104,1,3,10,17,27
105,1,3,14,17,31
106,1,3,13,14,27
107,1,3,80,26,106
108,1,3,21,27,48
109,1,3,12,17,29
110,1,3,12,7,19
111,1,3,85,44,129
112,1,3,24,21,45
113,1,3,5,12,17
114,1,3,78,77,155
115,1,3,11,19,30
116,1,3,12,18,30
117,1,3,18,24,42
118,1,3,21,36,57
119,1,3,60,51,111
120,1,3,18,22,40
121,1,3,7,6,13
122,1,3,8,6,14
123,1,3,22,37,59
124,1,3,2,3,5
125,1,3,18,15,33
126,1,3,13,6,19
127,1,3,11,7,18
128,1,3,3,8,11
129,1,3,36,29,65
130,1,3,23,42,65
131,1,3,31,34,65
132,1,3,2,8,10
133,1,3,3,3,6
134,1,3,56,51,107
135,1,3,35,36,71
136,1,3,18,28,46
137,1,3,1,5,6
138,1,3,15,5,20
139,1,3,7,12,19
140,1,3,30,47,77
141,1,3,52,44,96
142,1,3,7,2,9
143,1,3,11,10,21
144,1,3,5,8,13
145,1,3,16,25,41
146,1,3,5,6,11
147,1,3,14,19,33
148,1,3,1,2,3
149,1,3,19,35,54
150,1,3,50,13,63
151,1,3,35,21,56
152,1,3,6,11,17
153,1,3,0,6,6
154,1,3,49,71,120
155,1,3,18,12,30
156,1,3,8,14,22
157,1,3,4,12,16
158,1,3,10,13,23
159,1,3,12,19,31
160,1,3,11,14,25
161,1,3,31,30,61
162,1,3,0,1,1
163,1,3,6,8,14
164,1,3,6,10,16
165,1,3,0,0,0
166,1,3,77,28,105
167,1,3,3,4,7
168,1,3,0,1,1
169,1,3,20,24,44
170,1,3,39,56,95
171,1,3,0,4,4
172,1,3,2,3,5
173,1,3,24,32,56
174,1,3,17,16,33
175,1,3,9,3,12
176,1,3,4,1,5
177,1,3,32,17,49
178,1,3,0,1,1
179,1,3,6,6,12
180,1,3,16,13,29
181,1,3,7,15,22
182,1,3,8,6,14
183,1,3,27,42,69
184,1,3,13,19,32
185,1,3,5,7,12
186,1,3,49,27,76
187,1,3,147,93,240
188,1,3,53,52,105
189,1,3,1,0,1
190,1,3,21,29,50
191,1,3,8,9,17
192,1,3,10,3,13
193,1,3,7,13,20
194,1,3,29,25,54
195,1,3,14,20,34
196,1,3,14,7,21
197,1,3,2,4,6
198,1,3,15,5,20
199,1,3,0,0,0
200,1,3,3,19,22
201,1,3,26,20,46
202,1,3,0,0,0
203,1,3,39,38,77
204,1,3,105,97,202
205,1,3,1,5,6
206,1,3,1,2,3
207,1,3,32,57,89
208,1,3,2,2,4
209,1,3,39,44,83
210,1,3,3,6,9
211,1,3,68,59,127
212,1,3,0,0,0
213,1,3,18,16,34
214,1,3,19,12,31
215,1,3,14,17,31
216,1,3,0,1,1
217,1,3,5,2,7
218,1,3,1,1,2
219,1,3,15,18,33
220,1,3,1,0,1
221,1,3,97,117,214
222,1,3,129,124,253
223,1,3,47,12,59
224,1,3,5,6,11
225,1,3,0,0,0
226,1,3,65,65,130
227,1,3,0,1,1
228,1,3,10,17,27
229,1,3,1,8,9
230,1,3,14,22,36
231,1,3,32,28,60
232,1,3,7,17,24
233,1,3,75,85,160
234,1,3,20,11,31
235,1,3,1,3,4
236,1,3,12,14,26
237,1,3,13,19,32
238,1,3,10,4,14
239,1,3,3,1,4
240,1,3,24,5,29
241,1,3,13,12,25
242,1,3,18,7,25
243,1,3,13,63,76
244,1,3,29,41,70
245,1,3,13,10,23
246,1,3,3,1,4
247,1,3,26,18,44
248,1,3,47,38,85
249,1,3,36,17,53
250,1,3,2,7,9
251,1,3,2,6,8
252,1,3,8,13,21
253,1,3,75,18,93
254,1,3,3,14,17
255,1,3,10,9,19
256,1,3,17,17,34
257,1,3,59,52,111
258,1,3,0,1,1
259,1,3,48,101,149
260,1,3,10,4,14
261,1,3,2,5,7
262,1,3,7,17,24
263,1,3,28,18,46
264,1,3,1,0,1
265,1,3,1,0,1
266,1,3,8,5,13
267,1,3,1,2,3
268,1,3,6,5,11
269,1,3,7,4,11
270,1,3,0,1,1
271,1,3,0,1,1
272,1,3,21,22,43
273,1,3,44,25,69
274,1,3,13,21,34
275,1,3,31,9,40
276,1,3,4,7,11
277,1,3,37,43,80
278,1,3,3,4,7
279,1,3,44,12,56
280,1,3,3,10,13
281,1,3,2,2,4
282,1,3,0,0,0
283,1,3,35,60,95
284,1,3,24,28,52
285,1,3,1,2,3
286,1,3,9,11,20
287,1,3,14,3,17
288,1,3,0,0,0
289,1,3,28,8,36
290,1,3,0,0,0
291,1,3,17,19,36
292,1,3,4,4,8
293,1,3,0,0,0
294,1,3,25,26,51
295,1,3,8,2,10
296,1,3,38,27,65
297,1,3,13,2,15
298,1,3,42,35,77
299,1,3,52,41,93
300,1,3,9,10,19
301,1,3,8,7,15
302,1,3,27,14,41
303,1,3,9,10,19
304,1,3,0,1,1
305,1,3,16,21,37
306,1,3,6,19,25
307,1,3,0,1,1
308,1,3,11,11,22
309,1,3,7,8,15
310,1,3,18,14,32
311,1,3,28,19,47
312,1,3,8,16,24
313,1,3,8,12,20
314,1,3,1,1,2
315,1,3,96,101,197
316,1,3,26,23,49
317,1,3,4,4,8
318,1,3,7,20,27
319,1,3,0,2,2
320,1,3,6,10,16
321,1,3,1,1,2
322,1,3,5,7,12
323,1,3,0,0,0
324,1,3,6,7,13
325,1,3,18,7,25
326,1,3,4,6,10
327,1,3,8,4,12
328,1,3,14,17,31
329,1,3,28,14,42
330,1,3,11,9,20
331,1,3,39,68,107
332,1,3,3,6,9
333,1,3,12,15,27
334,1,3,46,47,93
335,1,3,35,41,76
336,1,3,16,21,37
337,1,3,6,10,16
338,1,3,14,18,32
339,1,3,4,12,16
340,1,3,3,2,5
341,1,3,12,8,20
342,1,3,12,12,24
343,1,3,6,1,7
344,1,3,31,22,53
345,1,3,53,38,91
346,1,3,13,27,40
347,1,3,12,9,21
348,1,3,23,9,32
349,1,3,10,17,27
350,1,3,5,11,16
351,1,3,7,10,17
352,1,3,7,17,24
353,1,3,15,13,28
354,1,3,10,8,18
355,1,3,12,20,32
356,1,3,31,13,44
357,1,3,1,0,1
358,1,3,10,22,32
359,1,3,25,12,37
360,1,3,23,36,59
361,1,3,12,9,21
362,1,3,72,19,91
363,1,3,3,8,11
364,1,3,20,36,56
365,1,3,21,22,43
366,1,3,7,5,12
367,1,3,82,47,129
368,1,3,4,10,14
369,1,3,6,8,14
370,1,3,2,2,4
371,1,3,21,27,48
372,1,3,7,4,11
373,1,3,10,15,25
374,1,3,20,13,33
375,1,3,12,11,23
376,1,3,51,44,95
377,1,3,90,45,135
378,1,3,6,4,10
379,1,3,14,13,27
380,1,3,35,28,63
381,1,3,2,5,7
382,1,3,16,21,37
383,1,3,10,9,19
384,1,3,47,25,72
385,1,3,5,7,12
386,1,3,26,32,58
387,1,3,6,3,9
388,1,3,9,4,13
389,1,3,0,0,0
390,1,3,62,29,91
391,1,3,2,12,14
392,1,3,2,3,5
393,1,3,24,30,54
394,1,3,9,18,27
395,1,3,6,7,13
396,1,3,8,5,13
397,1,3,2,1,3
398,1,3,4,12,16
399,1,3,1,0,1
400,1,3,0,0,0
401,1,3,0,0,0
402,1,3,7,14,21
403,1,3,11,31,42
404,1,3,0,1,1
405,1,3,111,110,221
406,1,3,28,45,73
407,1,3,5,12,17
408,1,3,35,39,74
409,1,3,3,10,13
410,1,3,14,30,44
411,1,3,36,43,79
412,1,3,0,4,4
413,1,3,5,10,15
414,1,3,2,7,9
415,1,3,6,16,22
416,1,3,29,16,45
417,1,3,2,6,8
418,1,3,34,24,58
419,1,3,19,28,47
420,1,3,94,20,114
421,1,3,31,36,67
422,1,3,16,35,51
423,1,3,1,5,6
424,1,3,0,0,0
0,1,6,28,25,53
1,1,6,7,20,27
2,1,6,21,17,38
3,1,6,22,49,71
4,1,6,5,15,20
5,1,6,62,68,130
6,1,6,2,7,9
7,1,6,8,22,30
8,1,6,6,18,24
9,1,6,15,24,39
10,1,6,33,35,68
11,1,6,16,17,33
12,1,6,6,19,25
13,1,6,28,20,48
14,1,6,97,90,187
15,1,6,16,9,25
16,1,6,18,22,40
17,1,6,61,36,97
18,1,6,14,21,35
19,1,6,20,13,33
20,1,6,27,24,51
21,1,6,14,13,27
22,1,6,0,4,4
23,1,6,13,22,35
24,1,6,75,81,156
25,1,6,13,35,48
26,1,6,46,27,73
27,1,6,10,11,21
28,1,6,32,42,74
29,1,6,26,45,71
30,1,6,26,28,54
31,1,6,17,23,40
32,1,6,29,33,62
33,1,6,30,27,57
34,1,6,3,1,4
35,1,6,18,29,47
36,1,6,17,39,56
37,1,6,5,9,14
38,1,6,0,1,1
39,1,6,4,7,11
40,1,6,4,4,8
41,1,6,6,5,11
42,1,6,23,38,61
43,1,6,13,19,32
44,1,6,2,6,8
45,1,6,18,21,39
46,1,6,8,9,17
47,1,6,0,3,3
48,1,6,25,20,45
49,1,6,11,29,40
50,1,6,4,9,13
51,1,6,19,25,44
52,1,6,31,40,71
53,1,6,0,0,0
54,1,6,8,6,14
55,1,6,24,21,45
56,1,6,5,14,19
57,1,6,34,40,74
58,1,6,68,79,147
59,1,6,91,106,197
60,1,6,27,22,49
61,1,6,17,17,34
62,1,6,31,34,65
63,1,6,30,21,51
64,1,6,13,17,30
65,1,6,23,15,38
66,1,6,2,5,7
67,1,6,10,9,19
68,1,6,54,55,109
69,1,6,11,9,20
70,1,6,16,7,23
71,1,6,31,27,58
72,1,6,2,2,4
73,1,6,12,12,24
74,1,6,11,10,21
75,1,6,38,27,65
76,1,6,8,11,19
77,1,6,3,14,17
78,1,6,7,2,9
79,1,6,4,7,11
80,1,6,17,7,24
81,1,6,34,19,53
82,1,6,14,24,38
83,1,6,28,37,65
84,1,6,10,6,16
85,1,6,84,51,135
86,1,6,2,2,4
87,1,6,165,92,257
88,1,6,2,6,8
89,1,6,9,9,18
90,1,6,9,5,14
91,1,6,28,28,56
92,1,6,13,23,36
93,1,6,8,5,13
94,1,6,0,2,2
95,1,6,4,3,7
96,1,6,6,11,17
97,1,6,20,11,31
98,1,6,2,0,2
99,1,6,32,26,58
100,1,6,16,30,46
101,1,6,59,36,95
102,1,6,5,7,12
103,1,6,58,59,117
104,1,6,18,23,41
105,1,6,6,11,17
106,1,6,2,8,10
107,1,6,76,30,106
108,1,6,22,25,47
109,1,6,7,16,23
110,1,6,11,11,22
111,1,6,57,42,99
112,1,6,37,39,76
113,1,6,8,9,17
114,1,6,56,57,113
115,1,6,19,36,55
116,1,6,11,12,23
117,1,6,15,17,32
118,1,6,31,18,49
119,1,6,53,56,109
120,1,6,15,14,29
121,1,6,6,6,12
122,1,6,14,3,17
123,1,6,13,19,32
124,1,6,0,3,3
125,1,6,12,15,27
126,1,6,5,7,12
127,1,6,2,10,12
128,1,6,1,3,4
129,1,6,25,11,36
130,1,6,40,52,92
131,1,6,39,35,74
132,1,6,3,8,11
133,1,6,1,3,4
134,1,6,46,31,77
135,1,6,12,18,30
136,1,6,11,16,27
137,1,6,2,6,8
138,1,6,13,11,24
139,1,6,3,7,10
140,1,6,27,35,62
141,1,6,35,41,76
142,1,6,2,6,8
143,1,6,7,8,15
144,1,6,6,6,12
145,1,6,16,25,41
146,1,6,3,19,22
147,1,6,15,14,29
148,1,6,1,1,2
149,1,6,8,16,24
150,1,6,29,4,33
151,1,6,17,19,36
152,1,6,0,2,2
153,1,6,2,3,5
154,1,6,136,146,282
155,1,6,13,11,24
156,1,6,5,10,15
157,1,6,5,9,14
158,1,6,6,6,12
159,1,6,12,21,33
160,1,6,11,9,20
161,1,6,14,24,38
162,1,6,2,1,3
163,1,6,2,6,8
164,1,6,2,5,7
165,1,6,0,0,0
166,1,6,54,19,73
167,1,6,0,0,0
168,1,6,1,3,4
169,1,6,19,23,42
170,1,6,28,46,74
171,1,6,5,5,10
172,1,6,0,4,4
173,1,6,20,20,40
174,1,6,2,5,7
175,1,6,9,4,13
176,1,6,2,1,3
177,1,6,16,22,38
178,1,6,4,4,8
179,1,6,0,0,0
180,1,6,34,23,57
181,1,6,7,16,23
182,1,6,4,4,8
183,1,6,29,40,69
184,1,6,15,9,24
185,1,6,11,14,25
186,1,6,15,14,29
187,1,6,130,68,198
188,1,6,56,48,104
189,1,6,0,0,0
190,1,6,12,14,26
191,1,6,4,3,7
192,1,6,5,2,7
193,1,6,1,4,5
194,1,6,16,20,36
195,1,6,14,15,29
196,1,6,11,3,14
197,1,6,8,12,20
198,1,6,13,3,16
199,1,6,0,0,0
200,1,6,4,10,14
201,1,6,15,13,28
202,1,6,0,0,0
203,1,6,38,23,61
204,1,6,147,155,302
205,1,6,10,10,20
206,1,6,0,0,0
207,1,6,42,42,84
208,1,6,1,1,2
209,1,6,29,30,59
210,1,6,1,0,1
211,1,6,77,74,151
212,1,6,0,0,0
213,1,6,17,11,28
214,1,6,20,29,49
215,1,6,11,11,22
216,1,6,1,0,1
217,1,6,1,4,5
218,1,6,2,4,6
219,1,6,7,5,12
220,1,6,0,1,1
221,1,6,131,145,276
222,1,6,135,130,265
223,1,6,24,10,34
224,1,6,3,1,4
225,1,6,2,2,4
226,1,6,79,93,172
227,1,6,0,2,2
228,1,6,7,7,14
229,1,6,2,5,7
230,1,6,8,12,20
231,1,6,28,21,49
232,1,6,5,10,15
233,1,6,76,68,144
234,1,6,14,14,28
235,1,6,0,0,0
236,1,6,9,5,14
237,1,6,9,6,15
238,1,6,9,7,16
239,1,6,8,4,12
240,1,6,16,9,25
241,1,6,4,3,7
242,1,6,9,5,14
243,1,6,29,53,82
244,1,6,21,18,39
245,1,6,10,9,19
246,1,6,7,5,12
247,1,6,13,11,24
248,1,6,38,25,63
249,1,6,23,16,39
250,1,6,2,4,6
251,1,6,0,4,4
252,1,6,3,6,9
253,1,6,66,28,94
254,1,6,3,6,9
255,1,6,7,6,13
256,1,6,8,10,18
257,1,6,64,48,112
258,1,6,0,0,0
259,1,6,33,82,115
260,1,6,3,4,7
261,1,6,0,0,0
262,1,6,7,16,23
263,1,6,24,19,43
264,1,6,0,0,0
265,1,6,1,0,1
266,1,6,5,4,9
267,1,6,1,1,2
268,1,6,7,6,13
269,1,6,5,3,8
270,1,6,0,0,0
271,1,6,1,2,3
272,1,6,14,27,41
273,1,6,27,21,48
274,1,6,16,25,41
275,1,6,14,8,22
276,1,6,3,3,6
277,1,6,22,24,46
278,1,6,2,2,4
279,1,6,49,15,64
280,1,6,4,3,7
281,1,6,2,1,3
282,1,6,0,0,0
283,1,6,25,46,71
284,1,6,25,25,50
285,1,6,1,0,1
286,1,6,3,4,7
287,1,6,8,3,11
288,1,6,1,0,1
289,1,6,5,10,15
290,1,6,0,0,0
291,1,6,15,15,30
292,1,6,4,4,8
293,1,6,0,0,0
294,1,6,18,16,34
295,1,6,1,5,6
296,1,6,32,23,55
297,1,6,7,5,12
298,1,6,28,19,47
299,1,6,29,24,53
300,1,6,6,7,13
301,1,6,3,0,3
302,1,6,13,6,19
303,1,6,10,6,16
304,1,6,0,1,1
305,1,6,38,20,58
306,1,6,8,5,13
307,1,6,0,0,0
308,1,6,12,11,23
309,1,6,8,3,11
310,1,6,24,12,36
311,1,6,13,21,34
312,1,6,3,8,11
313,1,6,7,4,11
314,1,6,0,0,0
315,1,6,75,108,183
316,1,6,20,13,33
317,1,6,2,0,2
318,1,6,10,21,31
319,1,6,0,0,0
320,1,6,7,3,10
321,1,6,1,3,4
322,1,6,1,7,8
323,1,6,0,0,0
324,1,6,8,7,15
325,1,6,14,6,20
326,1,6,11,8,19
327,1,6,1,1,2
328,1,6,14,14,28
329,1,6,21,20,41
330,1,6,9,9,18
331,1,6,61,63,124
332,1,6,3,3,6
333,1,6,13,18,31
334,1,6,27,28,55
335,1,6,23,37,60
336,1,6,18,12,30
337,1,6,7,11,18
338,1,6,13,15,28
339,1,6,5,11,16
340,1,6,4,4,8
341,1,6,5,6,11
342,1,6,17,9,26
343,1,6,5,5,10
344,1,6,16,25,41
345,1,6,36,17,53
346,1,6,14,17,31
347,1,6,18,2,20
348,1,6,21,13,34
349,1,6,10,20,30
350,1,6,2,11,13
351,1,6,1,12,13
352,1,6,12,11,23
353,1,6,7,11,18
354,1,6,2,8,10
355,1,6,5,8,13
356,1,6,34,12,46
357,1,6,1,2,3
358,1,6,13,18,31
359,1,6,23,14,37
360,1,6,29,35,64
361,1,6,6,7,13
362,1,6,39,22,61
363,1,6,2,8,10
364,1,6,13,20,33
365,1,6,24,18,42
366,1,6,7,2,9
367,1,6,73,22,95
368,1,6,6,5,11
369,1,6,8,15,23
370,1,6,1,2,3
371,1,6,9,19,28
372,1,6,8,2,10
373,1,6,7,13,20
374,1,6,10,16,26
375,1,6,9,8,17
376,1,6,46,44,90
377,1,6,103,54,157
378,1,6,4,8,12
379,1,6,11,10,21
380,1,6,18,15,33
381,1,6,2,3,5
382,1,6,6,8,14
383,1,6,7,5,12
384,1,6,34,16,50
385,1,6,9,11,20
386,1,6,35,28,63
387,1,6,3,4,7
388,1,6,3,7,10
389,1,6,1,1,2
390,1,6,24,17,41
391,1,6,3,4,7
392,1,6,2,4,6
393,1,6,15,21,36
394,1,6,10,12,22
395,1,6,3,2,5
396,1,6,5,2,7
397,1,6,1,1,2
398,1,6,2,6,8
399,1,6,0,0,0
400,1,6,0,1,1
401,1,6,1,1,2
402,1,6,6,9,15
403,1,6,7,17,24
404,1,6,1,1,2
405,1,6,96,95,191
406,1,6,40,44,84
407,1,6,5,9,14
408,1,6,69,72,141
409,1,6,10,11,21
410,1,6,34,59,93
411,1,6,39,43,82
412,1,6,2,1,3
413,1,6,2,9,11
414,1,6,4,7,11
415,1,6,12,24,36
416,1,6,17,13,30
417,1,6,1,6,7
418,1,6,14,16,30
419,1,6,24,19,43
420,1,6,46,23,69
421,1,6,34,34,68
422,1,6,22,27,49
423,1,6,3,3,6
424,1,6,0,0,0
0,1,9,15,9,24
1,1,9,2,20,22
2,1,9,6,7,13
3,1,9,12,35,47
4,1,9,1,9,10
5,1,9,31,27,58
6,1,9,2,3,5
7,1,9,14,16,30
8,1,9,11,15,26
9,1,9,10,17,27
10,1,9,23,22,45
11,1,9,6,4,10
12,1,9,8,13,21
13,1,9,7,12,19
14,1,9,37,40,77
15,1,9,9,7,16
16,1,9,9,11,20
17,1,9,34,22,56
18,1,9,7,19,26
19,1,9,5,8,13
20,1,9,16,16,32
21,1,9,12,9,21
22,1,9,0,2,2
23,1,9,6,19,25
24,1,9,32,37,69
25,1,9,12,29,41
26,1,9,29,25,54
27,1,9,3,9,12
28,1,9,20,33,53
29,1,9,11,39,50
30,1,9,4,8,12
31,1,9,3,6,9
32,1,9,20,25,45
33,1,9,13,19,32
34,1,9,1,1,2
35,1,9,14,15,29
36,1,9,6,27,33
37,1,9,1,3,4
38,1,9,1,0,1
39,1,9,5,6,11
40,1,9,2,4,6
41,1,9,4,3,7
42,1,9,8,7,15
43,1,9,8,14,22
44,1,9,3,1,4
45,1,9,13,14,27
46,1,9,5,13,18
47,1,9,3,3,6
48,1,9,17,10,27
49,1,9,11,16,27
50,1,9,2,4,6
51,1,9,9,7,16
52,1,9,16,18,34
53,1,9,0,0,0
54,1,9,7,10,17
55,1,9,17,21,38
56,1,9,1,6,7
57,1,9,13,26,39
58,1,9,18,18,36
59,1,9,28,33,61
60,1,9,17,20,37
61,1,9,7,7,14
62,1,9,10,10,20
63,1,9,19,29,48
64,1,9,11,17,28
65,1,9,11,9,20
66,1,9,3,2,5
67,1,9,6,6,12
68,1,9,20,20,40
69,1,9,9,10,19
70,1,9,12,6,18
71,1,9,12,20,32
72,1,9,0,1,1
73,1,9,8,14,22
74,1,9,4,6,10
75,1,9,22,21,43
76,1,9,3,7,10
77,1,9,3,7,10
78,1,9,10,6,16
79,1,9,5,4,9
80,1,9,17,8,25
81,1,9,15,8,23
82,1,9,9,3,12
83,1,9,9,16,25
84,1,9,8,4,12
85,1,9,99,39,138
86,1,9,5,0,5
87,1,9,137,56,193
88,1,9,1,7,8
89,1,9,6,1,7
90,1,9,6,6,12
91,1,9,16,6,22
92,1,9,0,6,6
93,1,9,2,6,8
94,1,9,0,1,1
95,1,9,0,3,3
96,1,9,6,6,12
97,1,9,11,5,16
98,1,9,0,0,0
99,1,9,14,12,26
100,1,9,4,13,17
101,1,9,27,29,56
102,1,9,2,4,6
103,1,9,35,33,68
104,1,9,2,7,9
105,1,9,6,11,17
106,1,9,1,6,7
107,1,9,37,7,44
108,1,9,6,7,13
109,1,9,2,9,11
110,1,9,10,7,17
111,1,9,31,20,51
112,1,9,18,13,31
113,1,9,3,7,10
114,1,9,38,45,83
115,1,9,29,34,63
116,1,9,2,2,4
117,1,9,8,14,22
118,1,9,4,12,16
119,1,9,33,28,61
120,1,9,6,5,11
121,1,9,4,5,9
122,1,9,7,2,9
123,1,9,7,12,19
124,1,9,0,1,1
125,1,9,13,4,17
126,1,9,4,3,7
127,1,9,4,4,8
128,1,9,1,2,3
129,1,9,10,16,26
130,1,9,16,23,39
131,1,9,14,13,27
132,1,9,2,3,5
133,1,9,1,1,2
134,1,9,26,20,46
135,1,9,20,33,53
136,1,9,2,3,5
137,1,9,0,2,2
138,1,9,8,10,18
139,1,9,1,0,1
140,1,9,15,18,33
141,1,9,26,21,47
142,1,9,5,2,7
143,1,9,1,2,3
144,1,9,0,1,1
145,1,9,12,19,31
146,1,9,2,8,10
147,1,9,5,6,11
148,1,9,0,2,2
149,1,9,1,6,7
150,1,9,3,0,3
151,1,9,13,13,26
152,1,9,1,3,4
153,1,9,2,4,6
154,1,9,33,43,76
155,1,9,10,9,19
156,1,9,6,6,12
157,1,9,3,1,4
158,1,9,1,2,3
159,1,9,6,8,14
160,1,9,3,7,10
161,1,9,22,9,31
162,1,9,0,0,0
163,1,9,2,2,4
164,1,9,1,1,2
165,1,9,0,0,0
166,1,9,8,6,14
167,1,9,0,2,2
168,1,9,0,4,4
169,1,9,8,6,14
170,1,9,15,19,34
171,1,9,0,2,2
172,1,9,0,2,2
173,1,9,9,12,21
174,1,9,2,5,7
175,1,9,5,4,9
176,1,9,1,3,4
177,1,9,12,12,24
178,1,9,0,0,0
179,1,9,0,4,4
180,1,9,6,6,12
181,1,9,6,7,13
182,1,9,0,2,2
183,1,9,19,23,42
184,1,9,7,8,15
185,1,9,4,10,14
186,1,9,22,6,28
187,1,9,101,44,145
188,1,9,27,23,50
189,1,9,0,0,0
190,1,9,6,11,17
191,1,9,2,2,4
192,1,9,0,0,0
193,1,9,1,0,1
194,1,9,8,13,21
195,1,9,2,10,12
196,1,9,2,2,4
197,1,9,7,10,17
198,1,9,7,3,10
199,1,9,0,0,0
200,1,9,3,4,7
201,1,9,9,2,11
202,1,9,0,0,0
203,1,9,15,13,28
204,1,9,78,71,149
205,1,9,4,4,8
206,1,9,0,0,0
207,1,9,19,27,46
208,1,9,0,1,1
209,1,9,15,16,31
210,1,9,4,4,8
211,1,9,39,36,75
212,1,9,0,0,0
213,1,9,3,4,7
214,1,9,4,2,6
215,1,9,4,8,12
216,1,9,0,0,0
217,1,9,0,0,0
218,1,9,1,1,2
219,1,9,6,7,13
220,1,9,0,0,0
221,1,9,67,77,144
222,1,9,77,70,147
223,1,9,9,2,11
224,1,9,3,0,3
225,1,9,0,0,0
226,1,9,24,30,54
227,1,9,0,1,1
228,1,9,3,2,5
229,1,9,1,2,3
230,1,9,5,7,12
231,1,9,13,12,25
232,1,9,1,4,5
233,1,9,37,37,74
234,1,9,8,5,13
235,1,9,0,0,0
236,1,9,8,7,15
237,1,9,5,4,9
238,1,9,0,1,1
239,1,9,3,1,4
240,1,9,6,4,10
241,1,9,2,0,2
242,1,9,7,1,8
243,1,9,8,21,29
244,1,9,11,14,25
245,1,9,5,7,12
246,1,9,3,2,5
247,1,9,7,6,13
248,1,9,17,13,30
249,1,9,15,16,31
250,1,9,3,4,7
251,1,9,1,3,4
252,1,9,5,2,7
253,1,9,35,14,49
254,1,9,2,4,6
255,1,9,3,2,5
256,1,9,4,6,10
257,1,9,23,13,36
258,1,9,0,0,0
259,1,9,22,39,61
260,1,9,5,2,7
261,1,9,0,1,1
262,1,9,1,1,2
263,1,9,5,3,8
264,1,9,0,1,1
265,1,9,1,1,2
266,1,9,2,2,4
267,1,9,0,0,0
268,1,9,7,6,13
269,1,9,0,4,4
270,1,9,0,0,0
271,1,9,0,0,0
272,1,9,9,11,20
273,1,9,13,12,25
274,1,9,22,19,41
275,1,9,8,11,19
276,1,9,1,0,1
277,1,9,14,15,29
278,1,9,1,1,2
279,1,9,19,15,34
280,1,9,1,4,5
281,1,9,0,1,1
282,1,9,0,1,1
283,1,9,9,22,31
284,1,9,23,29,52
285,1,9,0,0,0
286,1,9,3,1,4
287,1,9,2,0,2
288,1,9,0,0,0
289,1,9,1,2,3
290,1,9,0,0,0
291,1,9,7,8,15
292,1,9,3,4,7
293,1,9,0,1,1
294,1,9,11,9,20
295,1,9,3,1,4
296,1,9,34,9,43
297,1,9,9,4,13
298,1,9,16,13,29
299,1,9,28,6,34
300,1,9,5,8,13
301,1,9,2,2,4
302,1,9,5,4,9
303,1,9,0,4,4
304,1,9,0,0,0
305,1,9,36,11,47
306,1,9,3,4,7
307,1,9,0,0,0
308,1,9,3,10,13
309,1,9,6,2,8
310,1,9,20,5,25
311,1,9,13,9,22
312,1,9,5,5,10
313,1,9,1,3,4
314,1,9,0,0,0
315,1,9,46,49,95
316,1,9,5,5,10
317,1,9,2,2,4
318,1,9,4,7,11
319,1,9,0,0,0
320,1,9,4,4,8
321,1,9,1,0,1
322,1,9,8,7,15
323,1,9,0,0,0
324,1,9,1,1,2
325,1,9,4,6,10
326,1,9,3,5,8
327,1,9,2,3,5
328,1,9,6,16,22
329,1,9,8,7,15
330,1,9,5,4,9
331,1,9,22,27,49
332,1,9,1,2,3
333,1,9,12,25,37
334,1,9,18,23,41
335,1,9,9,19,28
336,1,9,10,9,19
337,1,9,0,0,0
338,1,9,6,7,13
339,1,9,2,3,5
340,1,9,2,0,2
341,1,9,6,3,9
342,1,9,6,9,15
343,1,9,1,4,5
344,1,9,10,13,23
345,1,9,10,5,15
346,1,9,6,16,22
347,1,9,6,3,9
348,1,9,12,8,20
349,1,9,5,19,24
350,1,9,5,7,12
351,1,9,2,3,5
352,1,9,3,5,8
353,1,9,13,10,23
354,1,9,4,8,12
355,1,9,3,1,4
356,1,9,17,4,21
357,1,9,0,0,0
358,1,9,5,5,10
359,1,9,13,1,14
360,1,9,9,14,23
361,1,9,2,2,4
362,1,9,15,5,20
363,1,9,1,3,4
364,1,9,12,17,29
365,1,9,20,16,36
366,1,9,1,4,5
367,1,9,38,15,53
368,1,9,1,2,3
369,1,9,3,8,11
370,1,9,1,4,5
371,1,9,10,16,26
372,1,9,6,5,11
373,1,9,3,3,6
374,1,9,4,12,16
375,1,9,0,7,7
376,1,9,39,20,59
377,1,9,120,45,165
378,1,9,4,3,7
379,1,9,5,3,8
380,1,9,3,4,7
381,1,9,0,1,1
382,1,9,7,13,20
383,1,9,6,3,9
384,1,9,17,9,26
385,1,9,2,0,2
386,1,9,14,12,26
387,1,9,1,3,4
388,1,9,3,2,5
389,1,9,0,0,0
390,1,9,11,15,26
391,1,9,1,5,6
392,1,9,1,2,3
393,1,9,10,8,18
394,1,9,1,7,8
395,1,9,1,2,3
396,1,9,1,0,1
397,1,9,0,2,2
398,1,9,1,1,2
399,1,9,0,2,2
400,1,9,0,0,0
401,1,9,0,0,0
402,1,9,0,2,2
403,1,9,8,6,14
404,1,9,0,0,0
405,1,9,49,42,91
406,1,9,12,14,26
407,1,9,0,6,6
408,1,9,42,44,86
409,1,9,3,9,12
410,1,9,16,16,32
411,1,9,28,33,61
412,1,9,0,3,3
413,1,9,1,2,3
414,1,9,2,2,4
415,1,9,10,17,27
416,1,9,5,7,12
417,1,9,1,1,2
418,1,9,5,8,13
419,1,9,28,13,41
420,1,9,27,11,38
421,1,9,17,14,31
422,1,9,7,16,23
423,1,9,0,0,0
424,1,9,0,0,0
0,1,12,9,10,19
1,1,12,3,11,14
2,1,12,5,5,10
3,1,12,10,22,32
4,1,12,4,6,10
5,1,12,23,17,40
6,1,12,1,1,2
7,1,12,4,7,11
8,1,12,8,12,20
9,1,12,7,5,12
10,1,12,9,13,22
11,1,12,7,8,15
12,1,12,6,7,13
13,1,12,6,12,18
14,1,12,18,21,39
15,1,12,8,2,10
16,1,12,13,15,28
17,1,12,10,9,19
18,1,12,4,2,6
19,1,12,5,4,9
20,1,12,7,8,15
21,1,12,4,5,9
22,1,12,2,1,3
23,1,12,9,9,18
24,1,12,19,26,45
25,1,12,8,14,22
26,1,12,13,8,21
27,1,12,5,3,8
28,1,12,17,19,36
29,1,12,7,26,33
30,1,12,4,5,9
31,1,12,1,0,1
32,1,12,8,4,12
33,1,12,9,18,27
34,1,12,2,2,4
35,1,12,12,11,23
36,1,12,11,18,29
37,1,12,1,3,4
38,1,12,1,1,2
39,1,12,3,3,6
40,1,12,1,0,1
41,1,12,3,3,6
42,1,12,10,11,21
43,1,12,3,7,10
44,1,12,0,2,2
45,1,12,12,13,25
46,1,12,4,10,14
47,1,12,0,0,0
48,1,12,5,5,10
49,1,12,7,9,16
50,1,12,0,2,2
51,1,12,5,9,14
52,1,12,16,10,26
53,1,12,0,0,0
54,1,12,10,9,19
55,1,12,16,33,49
56,1,12,0,1,1
57,1,12,16,18,34
58,1,12,9,12,21
59,1,12,19,27,46
60,1,12,8,4,12
61,1,12,5,5,10
62,1,12,9,13,22
63,1,12,17,20,37
64,1,12,12,15,27
65,1,12,7,4,11
66,1,12,4,3,7
67,1,12,5,3,8
68,1,12,15,13,28
69,1,12,4,5,9
70,1,12,7,3,10
71,1,12,12,19,31
72,1,12,1,1,2
73,1,12,4,7,11
74,1,12,5,3,8
75,1,12,24,27,51
76,1,12,4,2,6
77,1,12,0,2,2
78,1,12,2,2,4
79,1,12,0,4,4
80,1,12,7,6,13
81,1,12,13,4,17
82,1,12,8,7,15
83,1,12,19,19,38
84,1,12,5,1,6
85,1,12,88,12,100
86,1,12,3,3,6
87,1,12,90,38,128
88,1,12,6,8,14
89,1,12,4,2,6
90,1,12,4,4,8
91,1,12,13,9,22
92,1,12,5,3,8
93,1,12,2,3,5
94,1,12,0,0,0
95,1,12,1,1,2
96,1,12,5,5,10
97,1,12,3,1,4
98,1,12,2,0,2
99,1,12,11,15,26
100,1,12,10,8,18
101,1,12,15,10,25
102,1,12,4,3,7
103,1,12,28,27,55
104,1,12,4,10,14
105,1,12,3,1,4
106,1,12,0,0,0
107,1,12,28,7,35
108,1,12,7,6,13
109,1,12,5,2,7
110,1,12,4,2,6
111,1,12,26,15,41
112,1,12,8,8,16
113,1,12,4,7,11
114,1,12,37,22,59
115,1,12,8,15,23
116,1,12,2,2,4
117,1,12,11,16,27
118,1,12,5,9,14
119,1,12,24,24,48
120,1,12,6,5,11
121,1,12,5,2,7
122,1,12,4,1,5
123,1,12,13,18,31
124,1,12,0,0,0
125,1,12,8,5,13
126,1,12,3,3,6
127,1,12,1,2,3
128,1,12,1,0,1
129,1,12,6,6,12
130,1,12,11,12,23
131,1,12,12,11,23
132,1,12,2,1,3
133,1,12,0,2,2
134,1,12,8,17,25
135,1,12,15,16,31
136,1,12,1,4,5
137,1,12,0,0,0
138,1,12,8,8,16
139,1,12,1,1,2
140,1,12,12,14,26
141,1,12,20,14,34
142,1,12,3,3,6
143,1,12,2,0,2
144,1,12,0,0,0
145,1,12,10,15,25
146,1,12,2,6,8
147,1,12,1,13,14
148,1,12,0,0,0
149,1,12,6,13,19
150,1,12,1,0,1
151,1,12,8,7,15
152,1,12,0,2,2
153,1,12,1,1,2
154,1,12,39,38,77
155,1,12,4,2,6
156,1,12,2,6,8
157,1,12,1,3,4
158,1,12,1,0,1
159,1,12,6,10,16
160,1,12,1,1,2
161,1,12,17,14,31
162,1,12,0,0,0
163,1,12,0,4,4
164,1,12,1,3,4
165,1,12,1,2,3
166,1,12,5,1,6
167,1,12,0,0,0
168,1,12,1,3,4
169,1,12,7,7,14
170,1,12,10,16,26
171,1,12,0,0,0
172,1,12,0,1,1
173,1,12,5,10,15
174,1,12,1,4,5
175,1,12,4,4,8
176,1,12,0,0,0
177,1,12,8,4,12
178,1,12,0,0,0
179,1,12,1,1,2
180,1,12,8,4,12
181,1,12,4,7,11
182,1,12,1,0,1
183,1,12,18,14,32
184,1,12,3,2,5
185,1,12,4,6,10
186,1,12,7,6,13
187,1,12,56,25,81
188,1,12,15,22,37
189,1,12,0,0,0
190,1,12,2,7,9
191,1,12,1,4,5
192,1,12,2,3,5
193,1,12,0,0,0
194,1,12,7,10,17
195,1,12,4,4,8
196,1,12,1,1,2
197,1,12,5,8,13
198,1,12,8,3,11
199,1,12,0,0,0
200,1,12,4,5,9
201,1,12,11,9,20
202,1,12,0,0,0
203,1,12,11,6,17
204,1,12,55,47,102
205,1,12,3,6,9
206,1,12,0,0,0
207,1,12,11,19,30
208,1,12,0,0,0
209,1,12,7,6,13
210,1,12,2,2,4
211,1,12,33,34,67
212,1,12,0,0,0
213,1,12,1,0,1
214,1,12,9,7,16
215,1,12,6,3,9
216,1,12,0,0,0
217,1,12,1,0,1
218,1,12,1,0,1
219,1,12,2,1,3
220,1,12,0,0,0
221,1,12,49,46,95
222,1,12,37,32,69
223,1,12,1,0,1
224,1,12,0,0,0
225,1,12,0,0,0
226,1,12,22,28,50
227,1,12,0,0,0
228,1,12,9,2,11
229,1,12,1,2,3
230,1,12,3,6,9
231,1,12,19,18,37
232,1,12,2,4,6
233,1,12,39,38,77
234,1,12,4,8,12
235,1,12,0,0,0
236,1,12,4,4,8
237,1,12,0,2,2
238,1,12,0,1,1
239,1,12,0,1,1
240,1,12,4,1,5
241,1,12,1,1,2
242,1,12,5,3,8
243,1,12,19,21,40
244,1,12,16,16,32
245,1,12,5,4,9
246,1,12,0,2,2
247,1,12,10,6,16
248,1,12,12,10,22
249,1,12,9,4,13
250,1,12,1,0,1
251,1,12,1,4,5
252,1,12,0,1,1
253,1,12,23,10,33
254,1,12,1,6,7
255,1,12,1,0,1
256,1,12,7,4,11
257,1,12,28,32,60
258,1,12,0,0,0
259,1,12,27,40,67
260,1,12,2,0,2
261,1,12,1,1,2
262,1,12,2,1,3
263,1,12,5,2,7
264,1,12,0,1,1
265,1,12,0,1,1
266,1,12,2,1,3
267,1,12,0,0,0
268,1,12,4,4,8
269,1,12,3,1,4
270,1,12,0,0,0
271,1,12,0,0,0
272,1,12,15,17,32
273,1,12,11,33,44
274,1,12,13,13,26
275,1,12,8,6,14
276,1,12,0,0,0
277,1,12,4,15,19
278,1,12,1,1,2
279,1,12,6,2,8
280,1,12,2,5,7
281,1,12,0,0,0
282,1,12,0,0,0
283,1,12,16,15,31
284,1,12,10,8,18
285,1,12,0,0,0
286,1,12,0,3,3
287,1,12,1,1,2
288,1,12,0,0,0
289,1,12,5,7,12
290,1,12,0,0,0
291,1,12,6,3,9
292,1,12,6,0,6
293,1,12,0,0,0
294,1,12,11,6,17
295,1,12,4,3,7
296,1,12,17,13,30
297,1,12,4,3,7
298,1,12,7,8,15
299,1,12,4,2,6
300,1,12,5,4,9
301,1,12,2,4,6
302,1,12,9,4,13
303,1,12,2,1,3
304,1,12,0,0,0
305,1,12,23,3,26
306,1,12,3,2,5
307,1,12,0,0,0
308,1,12,4,3,7
309,1,12,4,1,5
310,1,12,16,4,20
311,1,12,7,7,14
312,1,12,7,4,11
313,1,12,2,3,5
314,1,12,0,0,0
315,1,12,26,25,51
316,1,12,2,7,9
317,1,12,2,1,3
318,1,12,10,13,23
319,1,12,0,1,1
320,1,12,3,1,4
321,1,12,0,0,0
322,1,12,6,2,8
323,1,12,0,1,1
324,1,12,2,1,3
325,1,12,5,7,12
326,1,12,0,1,1
327,1,12,3,6,9
328,1,12,28,43,71
329,1,12,5,8,13
330,1,12,1,6,7
331,1,12,42,46,88
332,1,12,2,2,4
333,1,12,22,97,119
334,1,12,9,14,23
335,1,12,20,24,44
336,1,12,7,7,14
337,1,12,0,2,2
338,1,12,8,7,15
339,1,12,8,4,12
340,1,12,1,1,2
341,1,12,0,1,1
342,1,12,8,2,10
343,1,12,0,0,0
344,1,12,9,11,20
345,1,12,10,11,21
346,1,12,5,12,17
347,1,12,7,2,9
348,1,12,6,2,8
349,1,12,16,30,46
350,1,12,5,6,11
351,1,12,5,1,6
352,1,12,8,6,14
353,1,12,14,10,24
354,1,12,2,7,9
355,1,12,3,4,7
356,1,12,7,1,8
357,1,12,0,0,0
358,1,12,10,8,18
359,1,12,4,3,7
360,1,12,11,11,22
361,1,12,3,1,4
362,1,12,9,4,13
363,1,12,5,2,7
364,1,12,11,7,18
365,1,12,14,14,28
366,1,12,2,3,5
367,1,12,17,7,24
368,1,12,2,1,3
369,1,12,2,12,14
370,1,12,0,1,1
371,1,12,17,7,24
372,1,12,4,1,5
373,1,12,3,4,7
374,1,12,6,6,12
375,1,12,5,5,10
376,1,12,38,14,52
377,1,12,94,27,121
378,1,12,1,0,1
379,1,12,7,1,8
380,1,12,3,1,4
381,1,12,1,1,2
382,1,12,15,84,99
383,1,12,3,15,18
384,1,12,9,8,17
385,1,12,2,1,3
386,1,12,7,3,10
387,1,12,1,2,3
388,1,12,2,0,2
389,1,12,0,0,0
390,1,12,13,51,64
391,1,12,2,2,4
392,1,12,4,2,6
393,1,12,3,5,8
394,1,12,1,2,3
395,1,12,0,1,1
396,1,12,1,1,2
397,1,12,0,0,0
398,1,12,4,3,7
399,1,12,0,0,0
400,1,12,0,0,0
401,1,12,0,0,0
402,1,12,2,4,6
403,1,12,4,4,8
404,1,12,0,0,0
405,1,12,29,32,61
406,1,12,12,14,26
407,1,12,0,3,3
408,1,12,37,37,74
409,1,12,1,3,4
410,1,12,18,21,39
411,1,12,38,28,66
412,1,12,0,1,1
413,1,12,0,3,3
414,1,12,1,2,3
415,1,12,2,4,6
416,1,12,7,3,10
417,1,12,0,1,1
418,1,12,7,6,13
419,1,12,16,7,23
420,1,12,17,2,19
421,1,12,19,16,35
422,1,12,9,10,19
423,1,12,0,2,2
424,1,12,0,0,0
0,1,15,18,10,28
1,1,15,5,8,13
2,1,15,9,5,14
3,1,15,17,13,30
4,1,15,16,9,25
5,1,15,21,14,35
6,1,15,6,1,7
7,1,15,8,5,13
8,1,15,13,10,23
9,1,15,21,15,36
10,1,15,17,19,36
11,1,15,8,4,12
12,1,15,13,9,22
13,1,15,32,15,47
14,1,15,24,39,63
15,1,15,12,10,22
16,1,15,28,19,47
17,1,15,14,6,20
18,1,15,8,11,19
19,1,15,6,5,11
20,1,15,13,63,76
21,1,15,11,5,16
22,1,15,11,5,16
23,1,15,16,14,30
24,1,15,31,48,79
25,1,15,18,13,31
26,1,15,35,13,48
27,1,15,7,5,12
28,1,15,23,10,33
29,1,15,29,42,71
30,1,15,15,4,19
31,1,15,19,5,24
32,1,15,28,16,44
33,1,15,35,54,89
34,1,15,2,3,5
35,1,15,18,11,29
36,1,15,25,11,36
37,1,15,7,2,9
38,1,15,0,0,0
39,1,15,7,10,17
40,1,15,7,1,8
41,1,15,12,5,17
42,1,15,26,29,55
43,1,15,13,11,24
44,1,15,2,1,3
45,1,15,9,18,27
46,1,15,10,11,21
47,1,15,4,1,5
48,1,15,11,20,31
49,1,15,26,13,39
50,1,15,4,10,14
51,1,15,17,14,31
52,1,15,30,24,54
53,1,15,0,0,0
54,1,15,7,6,13
55,1,15,18,36,54
56,1,15,5,3,8
57,1,15,16,31,47
58,1,15,25,45,70
59,1,15,45,112,157
60,1,15,20,20,40
61,1,15,20,18,38
62,1,15,8,28,36
63,1,15,28,4,32
64,1,15,24,22,46
65,1,15,11,11,22
66,1,15,9,0,9
67,1,15,13,2,15
68,1,15,12,12,24
69,1,15,8,13,21
70,1,15,13,4,17
71,1,15,23,17,40
72,1,15,1,3,4
73,1,15,8,7,15
74,1,15,4,3,7
75,1,15,21,31,52
76,1,15,11,4,15
77,1,15,15,20,35
78,1,15,6,3,9
79,1,15,6,2,8
80,1,15,6,13,19
81,1,15,3,1,4
82,1,15,6,7,13
83,1,15,16,34,50
84,1,15,2,1,3
85,1,15,23,8,31
86,1,15,7,0,7
87,1,15,59,36,95
88,1,15,5,2,7
89,1,15,6,0,6
90,1,15,6,5,11
91,1,15,19,21,40
92,1,15,7,5,12
93,1,15,7,12,19
94,1,15,6,1,7
95,1,15,2,0,2
96,1,15,9,5,14
97,1,15,11,4,15
98,1,15,4,0,4
99,1,15,18,12,30
100,1,15,17,12,29
101,1,15,24,22,46
102,1,15,7,4,11
103,1,15,32,40,72
104,1,15,10,13,23
105,1,15,5,1,6
106,1,15,1,2,3
107,1,15,12,1,13
108,1,15,26,18,44
109,1,15,25,12,37
110,1,15,5,1,6
111,1,15,39,20,59
112,1,15,13,28,41
113,1,15,7,6,13
114,1,15,36,15,51
115,1,15,16,23,39
116,1,15,4,9,13
117,1,15,12,10,22
118,1,15,11,6,17
119,1,15,25,23,48
120,1,15,13,6,19
121,1,15,10,4,14
122,1,15,10,3,13
123,1,15,27,27,54
124,1,15,0,0,0
125,1,15,11,1,12
126,1,15,13,2,15
127,1,15,5,3,8
128,1,15,1,1,2
129,1,15,10,5,15
130,1,15,23,36,59
131,1,15,38,19,57
132,1,15,3,6,9
133,1,15,3,0,3
134,1,15,29,21,50
135,1,15,18,18,36
136,1,15,10,9,19
137,1,15,2,0,2
138,1,15,6,4,10
139,1,15,2,2,4
140,1,15,30,23,53
141,1,15,37,17,54
142,1,15,7,2,9
143,1,15,6,5,11
144,1,15,13,2,15
145,1,15,10,32,42
146,1,15,6,9,15
147,1,15,9,10,19
148,1,15,0,1,1
149,1,15,12,19,31
150,1,15,0,0,0
151,1,15,11,12,23
152,1,15,13,5,18
153,1,15,1,2,3
154,1,15,38,127,165
155,1,15,9,13,22
156,1,15,8,8,16
157,1,15,4,3,7
158,1,15,10,1,11
159,1,15,41,42,83
160,1,15,4,7,11
161,1,15,20,14,34
162,1,15,3,1,4
163,1,15,5,2,7
164,1,15,5,2,7
165,1,15,0,4,4
166,1,15,13,6,19
167,1,15,2,0,2
168,1,15,3,7,10
169,1,15,16,15,31
170,1,15,40,19,59
171,1,15,1,1,2
172,1,15,4,6,10
173,1,15,25,11,36
174,1,15,5,3,8
175,1,15,8,5,13
176,1,15,2,1,3
177,1,15,18,25,43
178,1,15,10,3,13
179,1,15,1,1,2
180,1,15,20,5,25
181,1,15,17,5,22
182,1,15,4,5,9
183,1,15,17,11,28
184,1,15,8,3,11
185,1,15,9,15,24
186,1,15,28,20,48
187,1,15,37,15,52
188,1,15,11,13,24
189,1,15,0,0,0
190,1,15,18,27,45
191,1,15,1,4,5
192,1,15,1,0,1
193,1,15,1,5,6
194,1,15,13,7,20
195,1,15,9,3,12
196,1,15,0,0,0
197,1,15,9,12,21
198,1,15,16,3,19
199,1,15,0,0,0
200,1,15,2,2,4
201,1,15,38,9,47
202,1,15,0,0,0
203,1,15,35,16,51
204,1,15,47,58,105
205,1,15,5,15,20
206,1,15,0,0,0
207,1,15,20,22,42
208,1,15,0,1,1
209,1,15,24,9,33
210,1,15,2,2,4
211,1,15,43,40,83
212,1,15,0,0,0
213,1,15,3,2,5
214,1,15,25,6,31
215,1,15,10,16,26
216,1,15,1,1,2
217,1,15,0,0,0
218,1,15,3,1,4
219,1,15,12,6,18
220,1,15,0,0,0
221,1,15,40,34,74
222,1,15,45,40,85
223,1,15,1,3,4
224,1,15,3,2,5
225,1,15,0,0,0
226,1,15,44,60,104
227,1,15,0,0,0
228,1,15,11,7,18
229,1,15,3,4,7
230,1,15,13,11,24
231,1,15,15,10,25
232,1,15,8,7,15
233,1,15,51,38,89
234,1,15,14,11,25
235,1,15,0,0,0
236,1,15,6,12,18
237,1,15,5,4,9
238,1,15,2,1,3
239,1,15,2,3,5
240,1,15,3,4,7
241,1,15,4,1,5
242,1,15,11,6,17
243,1,15,22,27,49
244,1,15,25,14,39
245,1,15,15,5,20
246,1,15,1,1,2
247,1,15,24,6,30
248,1,15,23,14,37
249,1,15,15,12,27
250,1,15,10,6,16
251,1,15,4,1,5
252,1,15,3,1,4
253,1,15,28,2,30
254,1,15,6,5,11
255,1,15,5,4,9
256,1,15,11,3,14
257,1,15,75,160,235
258,1,15,0,0,0
259,1,15,103,218,321
260,1,15,3,4,7
261,1,15,2,2,4
262,1,15,7,4,11
263,1,15,3,3,6
264,1,15,0,0,0
265,1,15,0,0,0
266,1,15,4,9,13
267,1,15,0,0,0
268,1,15,5,2,7
269,1,15,3,5,8
270,1,15,0,0,0
271,1,15,0,0,0
272,1,15,24,42,66
273,1,15,41,48,89
274,1,15,10,5,15
275,1,15,7,13,20
276,1,15,6,2,8
277,1,15,13,14,27
278,1,15,1,0,1
279,1,15,14,13,27
280,1,15,4,4,8
281,1,15,1,2,3
282,1,15,0,1,1
283,1,15,14,34,48
284,1,15,16,16,32
285,1,15,0,0,0
286,1,15,6,2,8
287,1,15,2,0,2
288,1,15,0,0,0
289,1,15,6,7,13
290,1,15,0,1,1
291,1,15,7,9,16
292,1,15,14,9,23
293,1,15,0,0,0
294,1,15,20,11,31
295,1,15,3,1,4
296,1,15,18,25,43
297,1,15,6,1,7
298,1,15,12,5,17
299,1,15,8,13,21
300,1,15,10,2,12
301,1,15,7,3,10
302,1,15,2,7,9
303,1,15,9,2,11
304,1,15,0,0,0
305,1,15,13,9,22
306,1,15,4,3,7
307,1,15,0,0,0
308,1,15,2,2,4
309,1,15,2,2,4
310,1,15,12,3,15
311,1,15,7,5,12
312,1,15,8,7,15
313,1,15,5,0,5
314,1,15,0,0,0
315,1,15,30,20,50
316,1,15,7,27,34
317,1,15,2,1,3
318,1,15,12,20,32
319,1,15,3,0,3
320,1,15,7,4,11
321,1,15,2,4,6
322,1,15,4,3,7
323,1,15,0,1,1
324,1,15,3,1,4
325,1,15,18,9,27
326,1,15,5,0,5
327,1,15,2,5,7
328,1,15,25,87,112
329,1,15,5,2,7
330,1,15,12,3,15
331,1,15,102,217,319
332,1,15,3,2,5
333,1,15,21,110,131
334,1,15,25,32,57
335,1,15,31,29,60
336,1,15,25,13,38
337,1,15,4,8,12
338,1,15,23,11,34
339,1,15,8,6,14
340,1,15,3,3,6
341,1,15,6,3,9
342,1,15,10,7,17
343,1,15,3,3,6
344,1,15,21,25,46
345,1,15,26,12,38
346,1,15,18,8,26
347,1,15,12,4,16
348,1,15,17,5,22
349,1,15,27,46,73
350,1,15,5,3,8
351,1,15,10,3,13
352,1,15,9,16,25
353,1,15,13,12,25
354,1,15,8,7,15
355,1,15,10,8,18
356,1,15,10,4,14
357,1,15,2,0,2
358,1,15,14,3,17
359,1,15,7,4,11
360,1,15,27,11,38
361,1,15,4,3,7
362,1,15,16,5,21
363,1,15,9,3,12
364,1,15,29,5,34
365,1,15,16,12,28
366,1,15,9,5,14
367,1,15,37,10,47
368,1,15,9,4,13
369,1,15,8,0,8
370,1,15,0,3,3
371,1,15,29,9,38
372,1,15,7,4,11
373,1,15,9,7,16
374,1,15,19,8,27
375,1,15,9,5,14
376,1,15,61,15,76
377,1,15,34,8,42
378,1,15,4,4,8
379,1,15,18,4,22
380,1,15,8,4,12
381,1,15,0,2,2
382,1,15,20,105,125
383,1,15,16,26,42
384,1,15,17,12,29
385,1,15,9,6,15
386,1,15,15,12,27
387,1,15,3,6,9
388,1,15,5,9,14
389,1,15,0,0,0
390,1,15,66,296,362
391,1,15,3,5,8
392,1,15,5,5,10
393,1,15,18,14,32
394,1,15,9,5,14
395,1,15,1,2,3
396,1,15,2,0,2
397,1,15,1,0,1
398,1,15,3,7,10
399,1,15,4,2,6
400,1,15,0,1,1
401,1,15,1,1,2
402,1,15,4,2,6
403,1,15,6,18,24
404,1,15,0,1,1
405,1,15,70,63,133
406,1,15,39,29,68
407,1,15,5,5,10
408,1,15,32,51,83
409,1,15,6,1,7
410,1,15,15,30,45
411,1,15,40,34,74
412,1,15,0,0,0
413,1,15,4,0,4
414,1,15,4,6,10
415,1,15,4,5,9
416,1,15,9,8,17
417,1,15,8,3,11
418,1,15,13,8,21
419,1,15,21,5,26
420,1,15,18,9,27
421,1,15,23,13,36
422,1,15,28,29,57
423,1,15,10,11,21
424,1,15,0,0,0
0,1,18,25,15,40
1,1,18,14,9,23
2,1,18,23,18,41
3,1,18,27,10,37
4,1,18,39,21,60
5,1,18,38,22,60
6,1,18,12,5,17
7,1,18,27,11,38
8,1,18,32,14,46
9,1,18,53,17,70
10,1,18,53,20,73
11,1,18,24,22,46
12,1,18,14,6,20
13,1,18,39,14,53
14,1,18,13,17,30
15,1,18,14,18,32
16,1,18,77,43,120
17,1,18,13,7,20
18,1,18,29,17,46
19,1,18,9,4,13
20,1,18,23,14,37
21,1,18,13,9,22
22,1,18,14,4,18
23,1,18,40,21,61
24,1,18,55,41,96
25,1,18,16,16,32
26,1,18,13,13,26
27,1,18,38,29,67
28,1,18,37,20,57
29,1,18,38,18,56
30,1,18,33,24,57
31,1,18,33,10,43
32,1,18,45,12,57
33,1,18,59,124,183
34,1,18,14,13,27
35,1,18,21,16,37
36,1,18,33,25,58
37,1,18,9,1,10
38,1,18,1,1,2
39,1,18,20,16,36
40,1,18,9,2,11
41,1,18,18,9,27
42,1,18,56,28,84
43,1,18,27,12,39
44,1,18,8,2,10
45,1,18,25,16,41
46,1,18,18,5,23
47,1,18,4,2,6
48,1,18,24,19,43
49,1,18,35,22,57
50,1,18,10,18,28
51,1,18,45,14,59
52,1,18,40,21,61
53,1,18,1,0,1
54,1,18,5,7,12
55,1,18,37,41,78
56,1,18,12,9,21
57,1,18,39,27,66
58,1,18,34,24,58
59,1,18,101,236,337
60,1,18,23,27,50
61,1,18,20,20,40
62,1,18,39,36,75
63,1,18,25,17,42
64,1,18,22,35,57
65,1,18,8,1,9
66,1,18,7,2,9
67,1,18,11,7,18
68,1,18,34,23,57
69,1,18,14,11,25
70,1,18,12,11,23
71,1,18,32,26,58
72,1,18,3,3,6
73,1,18,26,16,42
74,1,18,12,6,18
75,1,18,15,9,24
76,1,18,5,11,16
77,1,18,25,9,34
78,1,18,14,12,26
79,1,18,6,3,9
80,1,18,22,14,36
81,1,18,6,1,7
82,1,18,19,6,25
83,1,18,21,19,40
84,1,18,1,1,2
85,1,18,10,6,16
86,1,18,6,16,22
87,1,18,35,16,51
88,1,18,9,6,15
89,1,18,7,5,12
90,1,18,12,9,21
91,1,18,33,23,56
92,1,18,13,7,20
93,1,18,7,14,21
94,1,18,3,0,3
95,1,18,1,2,3
96,1,18,33,18,51
97,1,18,13,19,32
98,1,18,6,2,8
99,1,18,14,16,30
100,1,18,27,19,46
101,1,18,32,16,48
102,1,18,2,5,7
103,1,18,36,25,61
104,1,18,6,10,16
105,1,18,11,5,16
106,1,18,10,1,11
107,1,18,18,10,28
108,1,18,32,13,45
109,1,18,16,5,21
110,1,18,10,13,23
111,1,18,35,17,52
112,1,18,21,9,30
113,1,18,12,10,22
114,1,18,21,14,35
115,1,18,27,20,47
116,1,18,14,10,24
117,1,18,29,5,34
118,1,18,17,8,25
119,1,18,44,19,63
120,1,18,7,4,11
121,1,18,12,10,22
122,1,18,9,5,14
123,1,18,39,18,57
124,1,18,1,0,1
125,1,18,8,5,13
126,1,18,10,3,13
127,1,18,13,6,19
128,1,18,3,5,8
129,1,18,20,14,34
130,1,18,29,21,50
131,1,18,58,37,95
132,1,18,13,6,19
133,1,18,2,3,5
134,1,18,36,16,52
135,1,18,29,7,36
136,1,18,9,4,13
137,1,18,6,5,11
138,1,18,16,6,22
139,1,18,7,10,17
140,1,18,16,19,35
141,1,18,50,17,67
142,1,18,12,17,29
143,1,18,5,5,10
144,1,18,4,5,9
145,1,18,23,18,41
146,1,18,6,8,14
147,1,18,12,3,15
148,1,18,0,1,1
149,1,18,20,22,42
150,1,18,0,0,0
151,1,18,22,15,37
152,1,18,7,7,14
153,1,18,1,2,3
154,1,18,51,38,89
155,1,18,27,27,54
156,1,18,13,5,18
157,1,18,10,10,20
158,1,18,10,5,15
159,1,18,20,15,35
160,1,18,10,7,17
161,1,18,23,14,37
162,1,18,2,6,8
163,1,18,8,4,12
164,1,18,2,4,6
165,1,18,2,9,11
166,1,18,23,22,45
167,1,18,1,3,4
168,1,18,3,48,51
169,1,18,22,19,41
170,1,18,66,45,111
171,1,18,1,4,5
172,1,18,2,5,7
173,1,18,31,17,48
174,1,18,10,4,14
175,1,18,11,9,20
176,1,18,3,2,5
177,1,18,35,13,48
178,1,18,3,9,12
179,1,18,7,9,16
180,1,18,18,8,26
181,1,18,15,9,24
182,1,18,1,23,24
183,1,18,30,10,40
184,1,18,4,3,7
185,1,18,15,12,27
186,1,18,25,56,81
187,1,18,23,12,35
188,1,18,75,32,107
189,1,18,0,0,0
190,1,18,20,15,35
191,1,18,9,9,18
192,1,18,5,7,12
193,1,18,5,14,19
194,1,18,13,28,41
195,1,18,15,19,34
196,1,18,5,4,9
197,1,18,15,9,24
198,1,18,13,10,23
199,1,18,0,0,0
200,1,18,8,1,9
201,1,18,36,8,44
202,1,18,0,0,0
203,1,18,39,18,57
204,1,18,47,48,95
205,1,18,11,13,24
206,1,18,0,2,2
207,1,18,25,10,35
208,1,18,0,0,0
209,1,18,44,20,64
210,1,18,3,4,7
211,1,18,22,18,40
212,1,18,1,0,1
213,1,18,4,2,6
214,1,18,18,8,26
215,1,18,20,51,71
216,1,18,0,0,0
217,1,18,1,4,5
218,1,18,3,4,7
219,1,18,18,35,53
220,1,18,0,0,0
221,1,18,71,32,103
222,1,18,81,40,121
223,1,18,4,6,10
224,1,18,1,3,4
225,1,18,0,0,0
226,1,18,61,57,118
227,1,18,0,0,0
228,1,18,5,6,11
229,1,18,4,5,9
230,1,18,22,7,29
231,1,18,16,16,32
232,1,18,15,27,42
233,1,18,48,29,77
234,1,18,14,12,26
235,1,18,0,1,1
236,1,18,14,20,34
237,1,18,12,16,28
238,1,18,3,12,15
239,1,18,6,1,7
240,1,18,6,8,14
241,1,18,5,6,11
242,1,18,20,9,29
243,1,18,71,30,101
244,1,18,31,17,48
245,1,18,18,7,25
246,1,18,5,2,7
247,1,18,18,12,30
248,1,18,25,11,36
249,1,18,26,21,47
250,1,18,11,5,16
251,1,18,10,8,18
252,1,18,7,5,12
253,1,18,10,5,15
254,1,18,14,7,21
255,1,18,9,9,18
256,1,18,17,11,28
257,1,18,79,186,265
258,1,18,0,0,0
259,1,18,121,670,791
260,1,18,7,4,11
261,1,18,3,4,7
262,1,18,16,3,19
263,1,18,7,8,15
264,1,18,1,1,2
265,1,18,0,0,0
266,1,18,11,16,27
267,1,18,0,1,1
268,1,18,3,4,7
269,1,18,5,4,9
270,1,18,0,0,0
271,1,18,2,2,4
272,1,18,22,82,104
273,1,18,25,33,58
274,1,18,24,8,32
275,1,18,12,11,23
276,1,18,7,5,12
277,1,18,38,15,53
278,1,18,1,2,3
279,1,18,27,53,80
280,1,18,0,0,0
281,1,18,2,3,5
282,1,18,0,0,0
283,1,18,31,15,46
284,1,18,17,14,31
285,1,18,1,0,1
286,1,18,6,30,36
287,1,18,4,4,8
288,1,18,0,0,0
289,1,18,11,15,26
290,1,18,0,0,0
291,1,18,7,3,10
292,1,18,16,13,29
293,1,18,0,0,0
294,1,18,31,16,47
295,1,18,5,4,9
296,1,18,22,56,78
297,1,18,3,4,7
298,1,18,32,18,50
299,1,18,10,12,22
300,1,18,17,6,23
301,1,18,7,8,15
302,1,18,7,3,10
303,1,18,7,4,11
304,1,18,0,0,0
305,1,18,9,2,11
306,1,18,7,2,9
307,1,18,0,2,2
308,1,18,14,4,18
309,1,18,13,7,20
310,1,18,4,5,9
311,1,18,12,9,21
312,1,18,10,9,19
313,1,18,3,9,12
314,1,18,1,3,4
315,1,18,48,29,77
316,1,18,19,106,125
317,1,18,4,6,10
318,1,18,22,27,49
319,1,18,2,0,2
320,1,18,10,32,42
321,1,18,2,1,3
322,1,18,4,2,6
323,1,18,0,1,1
324,1,18,5,11,16
325,1,18,20,37,57
326,1,18,4,4,8
327,1,18,5,28,33
328,1,18,43,50,93
329,1,18,9,12,21
330,1,18,19,5,24
331,1,18,108,578,686
332,1,18,7,4,11
333,1,18,24,90,114
334,1,18,59,38,97
335,1,18,47,20,67
336,1,18,29,9,38
337,1,18,9,7,16
338,1,18,20,24,44
339,1,18,20,5,25
340,1,18,7,4,11
341,1,18,10,4,14
342,1,18,8,8,16
343,1,18,2,1,3
344,1,18,29,82,111
345,1,18,36,34,70
346,1,18,19,17,36
347,1,18,6,14,20
348,1,18,8,6,14
349,1,18,29,47,76
350,1,18,20,8,28
351,1,18,27,9,36
352,1,18,14,7,21
353,1,18,14,48,62
354,1,18,11,4,15
355,1,18,12,7,19
356,1,18,18,11,29
357,1,18,1,3,4
358,1,18,17,11,28
359,1,18,18,9,27
360,1,18,55,14,69
361,1,18,13,8,21
362,1,18,25,25,50
363,1,18,11,8,19
364,1,18,45,14,59
365,1,18,21,16,37
366,1,18,11,6,17
367,1,18,28,13,41
368,1,18,5,5,10
369,1,18,22,9,31
370,1,18,2,6,8
371,1,18,33,8,41
372,1,18,7,28,35
373,1,18,14,3,17
374,1,18,30,27,57
375,1,18,20,5,25
376,1,18,25,22,47
377,1,18,14,6,20
378,1,18,6,3,9
379,1,18,21,14,35
380,1,18,14,4,18
381,1,18,6,5,11
382,1,18,37,72,109
383,1,18,19,17,36
384,1,18,17,14,31
385,1,18,12,9,21
386,1,18,23,8,31
387,1,18,10,11,21
388,1,18,15,22,37
389,1,18,1,0,1
390,1,18,56,308,364
391,1,18,8,4,12
392,1,18,7,9,16
393,1,18,27,18,45
394,1,18,7,5,12
395,1,18,5,17,22
396,1,18,9,9,18
397,1,18,7,6,13
398,1,18,14,10,24
399,1,18,1,0,1
400,1,18,5,3,8
401,1,18,5,3,8
402,1,18,13,6,19
403,1,18,17,19,36
404,1,18,0,1,1
405,1,18,103,111,214
406,1,18,33,25,58
407,1,18,3,2,5
408,1,18,66,41,107
409,1,18,6,7,13
410,1,18,43,24,67
411,1,18,50,23,73
412,1,18,0,0,0
413,1,18,1,0,1
414,1,18,4,6,10
415,1,18,11,12,23
416,1,18,26,12,38
417,1,18,1,1,2
418,1,18,20,13,33
419,1,18,13,13,26
420,1,18,5,12,17
421,1,18,26,17,43
422,1,18,59,60,119
423,1,18,0,0,0
424,1,18,0,0,0
0,1,21,33,20,53
1,1,21,21,14,35
2,1,21,28,41,69
3,1,21,43,24,67
4,1,21,33,11,44
5,1,21,34,26,60
6,1,21,13,4,17
7,1,21,24,11,35
8,1,21,25,14,39
9,1,21,50,19,69
10,1,21,34,17,51
11,1,21,38,14,52
12,1,21,14,9,23
13,1,21,39,30,69
14,1,21,41,26,67
15,1,21,18,80,98
16,1,21,69,52,121
17,1,21,18,25,43
18,1,21,29,24,53
19,1,21,19,10,29
20,1,21,29,21,50
21,1,21,20,29,49
22,1,21,6,5,11
23,1,21,40,23,63
24,1,21,89,32,121
25,1,21,26,12,38
26,1,21,20,27,47
27,1,21,52,26,78
28,1,21,47,25,72
29,1,21,35,7,42
30,1,21,34,15,49
31,1,21,51,18,69
32,1,21,61,53,114
33,1,21,90,132,222
34,1,21,17,20,37
35,1,21,22,12,34
36,1,21,34,31,65
37,1,21,10,8,18
38,1,21,3,9,12
39,1,21,18,42,60
40,1,21,7,6,13
41,1,21,22,21,43
42,1,21,55,25,80
43,1,21,39,28,67
44,1,21,6,10,16
45,1,21,27,16,43
46,1,21,29,40,69
47,1,21,2,6,8
48,1,21,25,18,43
49,1,21,21,15,36
50,1,21,8,18,26
51,1,21,58,21,79
52,1,21,41,22,63
53,1,21,0,0,0
54,1,21,9,6,15
55,1,21,46,33,79
56,1,21,18,8,26
57,1,21,41,43,84
58,1,21,43,59,102
59,1,21,133,208,341
60,1,21,49,36,85
61,1,21,21,29,50
62,1,21,68,75,143
63,1,21,21,17,38
64,1,21,23,46,69
65,1,21,20,17,37
66,1,21,10,10,20
67,1,21,23,17,40
68,1,21,54,25,79
69,1,21,7,33,40
70,1,21,12,25,37
71,1,21,34,28,62
72,1,21,0,10,10
73,1,21,23,34,57
74,1,21,21,17,38
75,1,21,22,10,32
76,1,21,9,9,18
77,1,21,12,21,33
78,1,21,17,12,29
79,1,21,12,3,15
80,1,21,25,14,39
81,1,21,4,12,16
82,1,21,27,18,45
83,1,21,19,28,47
84,1,21,3,2,5
85,1,21,10,22,32
86,1,21,9,10,19
87,1,21,20,23,43
88,1,21,2,9,11
89,1,21,14,18,32
90,1,21,13,32,45
91,1,21,57,86,143
92,1,21,10,6,16
93,1,21,34,30,64
94,1,21,7,9,16
95,1,21,4,1,5
96,1,21,32,43,75
97,1,21,21,30,51
98,1,21,14,3,17
99,1,21,35,37,72
100,1,21,44,20,64
101,1,21,37,27,64
102,1,21,9,25,34
103,1,21,47,45,92
104,1,21,18,23,41
105,1,21,11,15,26
106,1,21,6,6,12
107,1,21,26,27,53
108,1,21,74,28,102
109,1,21,13,8,21
110,1,21,13,23,36
111,1,21,62,32,94
112,1,21,39,21,60
113,1,21,23,26,49
114,1,21,34,18,52
115,1,21,24,36,60
116,1,21,26,14,40
117,1,21,34,16,50
118,1,21,13,16,29
119,1,21,42,23,65
120,1,21,29,6,35
121,1,21,37,28,65
122,1,21,8,12,20
123,1,21,26,29,55
124,1,21,1,0,1
125,1,21,9,6,15
126,1,21,25,12,37
127,1,21,21,20,41
128,1,21,1,7,8
129,1,21,17,14,31
130,1,21,38,18,56
131,1,21,89,35,124
132,1,21,31,23,54
133,1,21,11,12,23
134,1,21,36,27,63
135,1,21,47,15,62
136,1,21,12,20,32
137,1,21,3,1,4
138,1,21,20,18,38
139,1,21,14,19,33
140,1,21,35,32,67
141,1,21,72,22,94
142,1,21,19,67,86
143,1,21,10,12,22
144,1,21,11,6,17
145,1,21,37,32,69
146,1,21,8,24,32
147,1,21,9,11,20
148,1,21,1,4,5
149,1,21,34,25,59
150,1,21,0,1,1
151,1,21,27,12,39
152,1,21,14,15,29
153,1,21,2,6,8
154,1,21,69,56,125
155,1,21,35,73,108
156,1,21,23,17,40
157,1,21,13,7,20
158,1,21,7,17,24
159,1,21,26,25,51
160,1,21,13,16,29
161,1,21,35,28,63
162,1,21,3,1,4
163,1,21,10,13,23
164,1,21,8,18,26
165,1,21,5,25,30
166,1,21,39,30,69
167,1,21,7,11,18
168,1,21,6,65,71
169,1,21,37,31,68
170,1,21,80,73,153
171,1,21,8,12,20
172,1,21,8,7,15
173,1,21,47,42,89
174,1,21,16,7,23
175,1,21,15,24,39
176,1,21,6,5,11
177,1,21,45,26,71
178,1,21,7,13,20
179,1,21,8,14,22
180,1,21,15,12,27
181,1,21,36,31,67
182,1,21,14,58,72
183,1,21,31,8,39
184,1,21,18,53,71
185,1,21,21,17,38
186,1,21,40,114,154
187,1,21,35,14,49
188,1,21,95,49,144
189,1,21,0,1,1
190,1,21,16,10,26
191,1,21,20,42,62
192,1,21,6,9,15
193,1,21,19,27,46
194,1,21,31,13,44
195,1,21,60,48,108
196,1,21,7,6,13
197,1,21,16,6,22
198,1,21,12,8,20
199,1,21,0,0,0
200,1,21,21,12,33
201,1,21,62,34,96
202,1,21,0,0,0
203,1,21,57,54,111
204,1,21,71,65,136
205,1,21,11,25,36
206,1,21,0,3,3
207,1,21,25,22,47
208,1,21,0,0,0
209,1,21,73,72,145
210,1,21,3,6,9
211,1,21,56,19,75
212,1,21,1,0,1
213,1,21,19,11,30
214,1,21,23,10,33
215,1,21,69,150,219
216,1,21,1,7,8
217,1,21,4,11,15
218,1,21,8,9,17
219,1,21,33,27,60
220,1,21,0,1,1
221,1,21,77,35,112
222,1,21,105,83,188
223,1,21,12,4,16
224,1,21,2,6,8
225,1,21,0,0,0
226,1,21,92,118,210
227,1,21,0,0,0
228,1,21,26,18,44
229,1,21,8,2,10
230,1,21,27,9,36
231,1,21,41,6,47
232,1,21,20,28,48
233,1,21,78,46,124
234,1,21,29,26,55
235,1,21,1,0,1
236,1,21,40,56,96
237,1,21,15,24,39
238,1,21,13,15,28
239,1,21,4,3,7
240,1,21,19,17,36
241,1,21,8,11,19
242,1,21,30,12,42
243,1,21,108,51,159
244,1,21,57,21,78
245,1,21,28,11,39
246,1,21,4,5,9
247,1,21,17,21,38
248,1,21,46,41,87
249,1,21,34,61,95
250,1,21,18,15,33
251,1,21,20,13,33
252,1,21,17,13,30
253,1,21,13,8,21
254,1,21,33,15,48
255,1,21,15,18,33
256,1,21,24,28,52
257,1,21,122,188,310
258,1,21,0,0,0
259,1,21,222,533,755
260,1,21,13,6,19
261,1,21,17,14,31
262,1,21,23,12,35
263,1,21,13,21,34
264,1,21,0,0,0
265,1,21,1,0,1
266,1,21,21,32,53
267,1,21,0,0,0
268,1,21,1,14,15
269,1,21,9,8,17
270,1,21,0,1,1
271,1,21,4,3,7
272,1,21,67,111,178
273,1,21,34,40,74
274,1,21,37,15,52
275,1,21,16,18,34
276,1,21,9,4,13
277,1,21,67,17,84
278,1,21,3,1,4
279,1,21,55,111,166
280,1,21,8,4,12
281,1,21,5,2,7
282,1,21,0,1,1
283,1,21,50,20,70
284,1,21,12,9,21
285,1,21,0,0,0
286,1,21,10,30,40
287,1,21,6,7,13
288,1,21,2,5,7
289,1,21,30,34,64
290,1,21,0,1,1
291,1,21,16,12,28
292,1,21,12,8,20
293,1,21,1,1,2
294,1,21,51,46,97
295,1,21,22,12,34
296,1,21,37,52,89
297,1,21,15,14,29
298,1,21,56,18,74
299,1,21,21,10,31
300,1,21,25,10,35
301,1,21,11,25,36
302,1,21,7,8,15
303,1,21,10,8,18
304,1,21,0,1,1
305,1,21,6,6,12
306,1,21,20,11,31
307,1,21,0,0,0
308,1,21,21,12,33
309,1,21,32,20,52
310,1,21,20,12,32
311,1,21,15,12,27
312,1,21,13,9,22
313,1,21,12,30,42
314,1,21,1,1,2
315,1,21,87,33,120
316,1,21,39,175,214
317,1,21,7,29,36
318,1,21,31,21,52
319,1,21,0,0,0
320,1,21,37,74,111
321,1,21,5,2,7
322,1,21,16,10,26
323,1,21,1,4,5
324,1,21,12,28,40
325,1,21,38,102,140
326,1,21,9,9,18
327,1,21,21,50,71
328,1,21,28,51,79
329,1,21,9,16,25
330,1,21,37,20,57
331,1,21,206,560,766
332,1,21,13,9,22
333,1,21,39,93,132
334,1,21,93,46,139
335,1,21,69,53,122
336,1,21,36,22,58
337,1,21,36,25,61
338,1,21,42,28,70
339,1,21,25,12,37
340,1,21,12,5,17
341,1,21,9,11,20
342,1,21,16,11,27
343,1,21,8,11,19
344,1,21,57,165,222
345,1,21,47,55,102
346,1,21,48,27,75
347,1,21,17,20,37
348,1,21,30,35,65
349,1,21,44,49,93
350,1,21,39,10,49
351,1,21,26,24,50
352,1,21,36,22,58
353,1,21,43,78,121
354,1,21,27,12,39
355,1,21,17,15,32
356,1,21,42,28,70
357,1,21,1,15,16
358,1,21,29,13,42
359,1,21,22,11,33
360,1,21,92,41,133
361,1,21,22,13,35
362,1,21,56,64,120
363,1,21,25,17,42
364,1,21,56,26,82
365,1,21,35,18,53
366,1,21,21,14,35
367,1,21,59,25,84
368,1,21,15,18,33
369,1,21,28,7,35
370,1,21,9,10,19
371,1,21,50,24,74
372,1,21,22,41,63
373,1,21,13,10,23
374,1,21,38,63,101
375,1,21,24,9,33
376,1,21,28,13,41
377,1,21,20,23,43
378,1,21,9,9,18
379,1,21,31,13,44
380,1,21,25,22,47
381,1,21,8,7,15
382,1,21,59,60,119
383,1,21,36,22,58
384,1,21,34,24,58
385,1,21,19,14,33
386,1,21,34,19,53
387,1,21,13,12,25
388,1,21,38,47,85
389,1,21,0,0,0
390,1,21,87,207,294
391,1,21,13,13,26
392,1,21,15,16,31
393,1,21,56,46,102
394,1,21,30,26,56
395,1,21,28,35,63
396,1,21,8,18,26
397,1,21,6,6,12
398,1,21,28,29,57
399,1,21,9,5,14
400,1,21,8,13,21
401,1,21,1,6,7
402,1,21,14,15,29
403,1,21,25,26,51
404,1,21,0,9,9
405,1,21,151,147,298
406,1,21,45,42,87
407,1,21,2,0,2
408,1,21,85,49,134
409,1,21,6,5,11
410,1,21,42,27,69
411,1,21,82,42,124
412,1,21,3,4,7
413,1,21,2,3,5
414,1,21,1,7,8
415,1,21,15,18,33
416,1,21,41,19,60
417,1,21,5,7,12
418,1,21,35,30,65
419,1,21,7,13,20
420,1,21,14,15,29
421,1,21,64,45,109
422,1,21,97,96,193
423,1,21,1,1,2
424,1,21,0,0,0
0,1,24,26,27,53
1,1,24,11,12,23
2,1,24,46,64,110
3,1,24,29,25,54
4,1,24,24,18,42
5,1,24,27,30,57
6,1,24,6,5,11
7,1,24,16,18,34
8,1,24,27,20,47
9,1,24,22,13,35
10,1,24,23,19,42
11,1,24,19,10,29
12,1,24,18,3,21
13,1,24,55,32,87
14,1,24,22,17,39
15,1,24,31,70,101
16,1,24,56,59,115
17,1,24,24,29,53
18,1,24,22,17,39
19,1,24,23,7,30
20,1,24,19,14,33
21,1,24,33,61,94
22,1,24,11,8,19
23,1,24,33,15,48
24,1,24,52,27,79
25,1,24,15,8,23
26,1,24,44,71,115
27,1,24,27,15,42
28,1,24,53,34,87
29,1,24,21,13,34
30,1,24,18,12,30
31,1,24,36,20,56
32,1,24,86,82,168
33,1,24,117,139,256
34,1,24,13,18,31
35,1,24,8,3,11
36,1,24,35,32,67
37,1,24,12,9,21
38,1,24,4,15,19
39,1,24,57,107,164
40,1,24,18,16,34
41,1,24,20,25,45
42,1,24,58,30,88
43,1,24,32,25,57
44,1,24,7,12,19
45,1,24,20,18,38
46,1,24,24,28,52
47,1,24,7,9,16
48,1,24,35,30,65
49,1,24,43,30,73
50,1,24,12,37,49
51,1,24,38,19,57
52,1,24,30,24,54
53,1,24,0,0,0
54,1,24,9,9,18
55,1,24,47,58,105
56,1,24,10,5,15
57,1,24,62,55,117
58,1,24,38,47,85
59,1,24,129,152,281
60,1,24,31,16,47
61,1,24,25,31,56
62,1,24,55,52,107
63,1,24,28,22,50
64,1,24,40,52,92
65,1,24,20,13,33
66,1,24,6,8,14
67,1,24,37,19,56
68,1,24,48,29,77
69,1,24,35,159,194
70,1,24,40,50,90
71,1,24,58,42,100
72,1,24,4,9,13
73,1,24,39,45,84
74,1,24,17,17,34
75,1,24,23,22,45
76,1,24,19,18,37
77,1,24,30,41,71
78,1,24,17,19,36
79,1,24,14,4,18
80,1,24,9,6,15
81,1,24,15,14,29
82,1,24,28,12,40
83,1,24,27,27,54
84,1,24,8,13,21
85,1,24,19,27,46
86,1,24,11,6,17
87,1,24,22,36,58
88,1,24,6,12,18
89,1,24,22,22,44
90,1,24,33,59,92
91,1,24,63,72,135
92,1,24,9,11,20
93,1,24,32,32,64
94,1,24,12,6,18
95,1,24,1,7,8
96,1,24,46,59,105
97,1,24,29,32,61
98,1,24,7,2,9
99,1,24,40,42,82
100,1,24,22,18,40
101,1,24,37,29,66
102,1,24,21,75,96
103,1,24,67,79,146
104,1,24,22,29,51
105,1,24,24,22,46
106,1,24,11,14,25
107,1,24,37,26,63
108,1,24,62,29,91
109,1,24,23,17,40
110,1,24,25,64,89
111,1,24,52,41,93
112,1,24,35,18,53
113,1,24,27,29,56
114,1,24,34,14,48
115,1,24,34,31,65
116,1,24,10,13,23
117,1,24,29,9,38
118,1,24,16,16,32
119,1,24,31,21,52
120,1,24,20,7,27
121,1,24,46,52,98
122,1,24,18,10,28
123,1,24,76,62,138
124,1,24,0,1,1
125,1,24,25,6,31
126,1,24,22,9,31
127,1,24,33,41,74
128,1,24,9,8,17
129,1,24,24,12,36
130,1,24,44,30,74
131,1,24,77,46,123
132,1,24,50,35,85
133,1,24,21,30,51
134,1,24,41,26,67
135,1,24,55,23,78
136,1,24,28,51,79
137,1,24,3,5,8
138,1,24,23,27,50
139,1,24,18,25,43
140,1,24,48,56,104
141,1,24,89,43,132
142,1,24,51,46,97
143,1,24,17,23,40
144,1,24,4,7,11
145,1,24,41,39,80
146,1,24,17,63,80
147,1,24,11,18,29
148,1,24,4,6,10
149,1,24,40,17,57
150,1,24,1,6,7
151,1,24,22,11,33
152,1,24,20,19,39
153,1,24,5,13,18
154,1,24,69,58,127
155,1,24,73,154,227
156,1,24,22,19,41
157,1,24,19,12,31
158,1,24,10,13,23
159,1,24,39,31,70
160,1,24,8,11,19
161,1,24,34,28,62
162,1,24,3,4,7
163,1,24,14,11,25
164,1,24,13,30,43
165,1,24,8,39,47
166,1,24,37,46,83
167,1,24,9,16,25
168,1,24,33,74,107
169,1,24,20,17,37
170,1,24,103,94,197
171,1,24,7,14,21
172,1,24,11,13,24
173,1,24,111,112,223
174,1,24,27,17,44
175,1,24,23,37,60
176,1,24,8,12,20
177,1,24,62,46,108
178,1,24,19,19,38
179,1,24,13,20,33
180,1,24,19,15,34
181,1,24,80,65,145
182,1,24,25,47,72
183,1,24,50,37,87
184,1,24,63,201,264
185,1,24,17,11,28
186,1,24,59,102,161
187,1,24,43,29,72
188,1,24,87,48,135
189,1,24,1,0,1
190,1,24,9,13,22
191,1,24,50,98,148
192,1,24,25,29,54
193,1,24,41,21,62
194,1,24,27,14,41
195,1,24,94,33,127
196,1,24,10,7,17
197,1,24,20,16,36
198,1,24,18,14,32
199,1,24,0,1,1
200,1,24,33,14,47
201,1,24,106,47,153
202,1,24,0,1,1
203,1,24,55,69,124
204,1,24,78,101,179
205,1,24,10,24,34
206,1,24,1,7,8
207,1,24,36,19,55
208,1,24,2,0,2
209,1,24,146,138,284
210,1,24,3,5,8
211,1,24,48,37,85
212,1,24,0,1,1
213,1,24,35,42,77
214,1,24,28,13,41
215,1,24,161,219,380
216,1,24,7,16,23
217,1,24,8,7,15
218,1,24,17,19,36
219,1,24,26,11,37
220,1,24,1,4,5
221,1,24,52,41,93
222,1,24,123,98,221
223,1,24,15,12,27
224,1,24,4,9,13
225,1,24,0,5,5
226,1,24,109,126,235
227,1,24,0,1,1
228,1,24,23,18,41
229,1,24,10,7,17
230,1,24,28,13,41
231,1,24,39,14,53
232,1,24,22,16,38
233,1,24,62,37,99
234,1,24,19,19,38
235,1,24,4,4,8
236,1,24,57,61,118
237,1,24,21,29,50
238,1,24,17,17,34
239,1,24,9,14,23
240,1,24,29,25,54
241,1,24,29,13,42
242,1,24,37,28,65
243,1,24,45,29,74
244,1,24,40,26,66
245,1,24,34,22,56
246,1,24,5,12,17
247,1,24,24,31,55
248,1,24,49,26,75
249,1,24,55,65,120
250,1,24,13,12,25
251,1,24,17,15,32
252,1,24,15,6,21
253,1,24,9,9,18
254,1,24,26,13,39
255,1,24,37,26,63
256,1,24,45,22,67
257,1,24,170,202,372
258,1,24,0,0,0
259,1,24,372,479,851
260,1,24,11,8,19
261,1,24,19,18,37
262,1,24,19,9,28
263,1,24,31,20,51
264,1,24,0,0,0
265,1,24,3,2,5
266,1,24,18,27,45
267,1,24,0,1,1
268,1,24,3,53,56
269,1,24,11,17,28
270,1,24,0,0,0
271,1,24,1,1,2
272,1,24,64,144,208
273,1,24,69,57,126
274,1,24,31,14,45
275,1,24,22,13,35
276,1,24,4,7,11
277,1,24,55,27,82
278,1,24,3,10,13
279,1,24,78,91,169
280,1,24,13,5,18
281,1,24,6,9,15
282,1,24,0,1,1
283,1,24,69,15,84
284,1,24,25,13,38
285,1,24,1,2,3
286,1,24,11,26,37
287,1,24,13,14,27
288,1,24,0,3,3
289,1,24,47,36,83
290,1,24,0,0,0
291,1,24,29,12,41
292,1,24,12,16,28
293,1,24,1,1,2
294,1,24,61,39,100
295,1,24,11,19,30
296,1,24,43,41,84
297,1,24,14,20,34
298,1,24,37,16,53
299,1,24,28,24,52
300,1,24,26,16,42
301,1,24,19,27,46
302,1,24,23,11,34
303,1,24,13,10,23
304,1,24,2,3,5
305,1,24,2,2,4
306,1,24,18,14,32
307,1,24,0,0,0
308,1,24,22,9,31
309,1,24,34,25,59
310,1,24,23,15,38
311,1,24,26,21,47
312,1,24,22,12,34
313,1,24,26,53,79
314,1,24,0,3,3
315,1,24,90,46,136
316,1,24,61,111,172
317,1,24,14,57,71
318,1,24,36,28,64
319,1,24,0,2,2
320,1,24,44,44,88
321,1,24,1,7,8
322,1,24,15,9,24
323,1,24,0,1,1
324,1,24,12,73,85
325,1,24,61,79,140
326,1,24,8,9,17
327,1,24,39,48,87
328,1,24,47,61,108
329,1,24,20,20,40
330,1,24,34,20,54
331,1,24,363,427,790
332,1,24,23,12,35
333,1,24,44,70,114
334,1,24,86,48,134
335,1,24,79,71,150
336,1,24,36,28,64
337,1,24,32,16,48
338,1,24,36,31,67
339,1,24,23,22,45
340,1,24,14,4,18
341,1,24,19,18,37
342,1,24,24,10,34
343,1,24,14,10,24
344,1,24,93,155,248
345,1,24,61,41,102
346,1,24,56,51,107
347,1,24,24,26,50
348,1,24,28,36,64
349,1,24,39,48,87
350,1,24,44,15,59
351,1,24,35,33,68
352,1,24,22,12,34
353,1,24,35,64,99
354,1,24,22,17,39
355,1,24,24,26,50
356,1,24,67,61,128
357,1,24,5,16,21
358,1,24,34,15,49
359,1,24,27,28,55
360,1,24,72,38,110
361,1,24,20,14,34
362,1,24,73,53,126
363,1,24,28,19,47
364,1,24,54,34,88
365,1,24,35,37,72
366,1,24,51,17,68
367,1,24,56,43,99
368,1,24,10,12,22
369,1,24,35,7,42
370,1,24,11,9,20
371,1,24,69,44,113
372,1,24,25,40,65
373,1,24,19,8,27
374,1,24,41,53,94
375,1,24,24,15,39
376,1,24,32,25,57
377,1,24,35,30,65
378,1,24,24,21,45
379,1,24,47,24,71
380,1,24,38,37,75
381,1,24,8,8,16
382,1,24,51,54,105
383,1,24,19,18,37
384,1,24,54,20,74
385,1,24,13,10,23
386,1,24,39,10,49
387,1,24,14,10,24
388,1,24,50,68,118
389,1,24,0,0,0
390,1,24,131,294,425
391,1,24,12,6,18
392,1,24,29,36,65
393,1,24,92,81,173
394,1,24,39,31,70
395,1,24,61,55,116
396,1,24,28,43,71
397,1,24,13,7,20
398,1,24,49,33,82
399,1,24,13,20,33
400,1,24,18,23,41
401,1,24,11,24,35
402,1,24,18,19,37
403,1,24,67,50,117
404,1,24,0,7,7
405,1,24,163,164,327
406,1,24,63,69,132
407,1,24,4,1,5
408,1,24,65,54,119
409,1,24,9,7,16
410,1,24,42,14,56
411,1,24,87,62,149
412,1,24,1,2,3
413,1,24,4,5,9
414,1,24,10,11,21
415,1,24,20,30,50
416,1,24,45,24,69
417,1,24,2,2,4
418,1,24,32,40,72
419,1,24,12,16,28
420,1,24,9,23,32
421,1,24,66,45,111
422,1,24,87,105,192
423,1,24,1,4,5
424,1,24,0,0,0
0,1,27,48,55,103
1,1,27,15,16,31
2,1,27,43,56,99
3,1,27,34,14,48
4,1,27,28,24,52
5,1,27,30,21,51
6,1,27,14,18,32
7,1,27,27,26,53
8,1,27,33,28,61
9,1,27,21,20,41
10,1,27,32,22,54
11,1,27,14,7,21
12,1,27,7,7,14
13,1,27,55,35,90
14,1,27,18,17,35
15,1,27,44,76,120
16,1,27,71,65,136
17,1,27,41,25,66
18,1,27,26,16,42
19,1,27,33,15,48
20,1,27,7,12,19
21,1,27,46,50,96
22,1,27,7,11,18
23,1,27,40,26,66
24,1,27,34,18,52
25,1,27,19,10,29
26,1,27,47,63,110
27,1,27,17,20,37
28,1,27,34,21,55
29,1,27,21,13,34
30,1,27,27,25,52
31,1,27,28,18,46
32,1,27,87,94,181
33,1,27,152,153,305
34,1,27,20,14,34
35,1,27,22,18,40
36,1,27,41,27,68
37,1,27,3,4,7
38,1,27,7,20,27
39,1,27,45,72,117
40,1,27,11,16,27
41,1,27,19,21,40
42,1,27,47,16,63
43,1,27,22,18,40
44,1,27,9,10,19
45,1,27,20,8,28
46,1,27,27,22,49
47,1,27,11,9,20
48,1,27,23,34,57
49,1,27,83,44,127
50,1,27,21,31,52
51,1,27,41,21,62
52,1,27,39,16,55
53,1,27,0,0,0
54,1,27,6,6,12
55,1,27,56,60,116
56,1,27,4,7,11
57,1,27,41,46,87
58,1,27,51,55,106
59,1,27,126,131,257
60,1,27,38,19,57
61,1,27,29,33,62
62,1,27,47,51,98
63,1,27,20,15,35
64,1,27,50,58,108
65,1,27,12,10,22
66,1,27,8,7,15
67,1,27,36,15,51
68,1,27,43,29,72
69,1,27,41,188,229
70,1,27,39,34,73
71,1,27,58,44,102
72,1,27,0,9,9
73,1,27,44,37,81
74,1,27,11,13,24
75,1,27,16,10,26
76,1,27,18,19,37
77,1,27,56,28,84
78,1,27,21,12,33
79,1,27,8,10,18
80,1,27,16,15,31
81,1,27,12,15,27
82,1,27,18,11,29
83,1,27,23,36,59
84,1,27,9,10,19
85,1,27,17,29,46
86,1,27,7,13,20
87,1,27,39,35,74
88,1,27,9,13,22
89,1,27,18,13,31
90,1,27,58,55,113
91,1,27,78,78,156
92,1,27,15,21,36
93,1,27,25,24,49
94,1,27,14,9,23
95,1,27,3,6,9
96,1,27,37,54,91
97,1,27,30,35,65
98,1,27,24,14,38
99,1,27,41,40,81
100,1,27,27,23,50
101,1,27,21,16,37
102,1,27,22,51,73
103,1,27,51,147,198
104,1,27,29,34,63
105,1,27,26,17,43
106,1,27,14,20,34
107,1,27,24,22,46
108,1,27,41,27,68
109,1,27,15,18,33
110,1,27,33,36,69
111,1,27,39,29,68
112,1,27,29,24,53
113,1,27,21,25,46
114,1,27,20,10,30
115,1,27,46,56,102
116,1,27,21,15,36
117,1,27,17,16,33
118,1,27,11,6,17
119,1,27,26,18,44
120,1,27,14,4,18
121,1,27,50,41,91
122,1,27,17,9,26
123,1,27,60,59,119
124,1,27,0,2,2
125,1,27,18,9,27
126,1,27,28,16,44
127,1,27,28,24,52
128,1,27,10,12,22
129,1,27,32,22,54
130,1,27,41,24,65
131,1,27,59,40,99
132,1,27,26,13,39
133,1,27,18,36,54
134,1,27,35,19,54
135,1,27,53,30,83
136,1,27,24,28,52
137,1,27,6,3,9
138,1,27,26,25,51
139,1,27,11,14,25
140,1,27,64,60,124
141,1,27,125,54,179
142,1,27,34,47,81
143,1,27,24,40,64
144,1,27,14,8,22
145,1,27,31,36,67
146,1,27,23,60,83
147,1,27,6,10,16
148,1,27,6,8,14
149,1,27,40,26,66
150,1,27,0,5,5
151,1,27,21,13,34
152,1,27,24,40,64
153,1,27,8,23,31
154,1,27,43,58,101
155,1,27,97,123,220
156,1,27,24,18,42
157,1,27,13,17,30
158,1,27,12,12,24
159,1,27,25,25,50
160,1,27,8,6,14
161,1,27,36,30,66
162,1,27,6,9,15
163,1,27,22,7,29
164,1,27,13,22,35
165,1,27,17,56,73
166,1,27,56,48,104
167,1,27,6,6,12
168,1,27,47,82,129
169,1,27,19,13,32
170,1,27,103,89,192
171,1,27,17,21,38
172,1,27,10,10,20
173,1,27,124,87,211
174,1,27,15,17,32
175,1,27,16,25,41
176,1,27,11,7,18
177,1,27,46,25,71
178,1,27,16,28,44
179,1,27,7,17,24
180,1,27,19,16,35
181,1,27,95,90,185
182,1,27,50,52,102
183,1,27,38,32,70
184,1,27,82,248,330
185,1,27,21,12,33
186,1,27,85,102,187
187,1,27,39,44,83
188,1,27,46,26,72
189,1,27,0,1,1
190,1,27,11,24,35
191,1,27,38,47,85
192,1,27,21,18,39
193,1,27,30,30,60
194,1,27,28,22,50
195,1,27,92,36,128
196,1,27,14,10,24
197,1,27,5,11,16
198,1,27,21,10,31
199,1,27,0,1,1
200,1,27,28,13,41
201,1,27,114,38,152
202,1,27,1,1,2
203,1,27,65,59,124
204,1,27,55,61,116
205,1,27,13,13,26
206,1,27,6,8,14
207,1,27,47,39,86
208,1,27,0,4,4
209,1,27,170,143,313
210,1,27,6,4,10
211,1,27,34,25,59
212,1,27,0,0,0
213,1,27,47,49,96
214,1,27,35,12,47
215,1,27,153,162,315
216,1,27,3,5,8
217,1,27,9,6,15
218,1,27,15,20,35
219,1,27,35,27,62
220,1,27,7,13,20
221,1,27,49,34,83
222,1,27,96,83,179
223,1,27,24,22,46
224,1,27,8,5,13
225,1,27,0,9,9
226,1,27,119,137,256
227,1,27,0,0,0
228,1,27,27,20,47
229,1,27,4,13,17
230,1,27,31,13,44
231,1,27,29,19,48
232,1,27,15,8,23
233,1,27,62,51,113
234,1,27,22,15,37
235,1,27,4,1,5
236,1,27,51,56,107
237,1,27,24,37,61
238,1,27,13,15,28
239,1,27,9,9,18
240,1,27,22,31,53
241,1,27,15,26,41
242,1,27,26,22,48
243,1,27,32,30,62
244,1,27,46,19,65
245,1,27,28,16,44
246,1,27,7,6,13
247,1,27,37,27,64
248,1,27,51,37,88
249,1,27,64,46,110
250,1,27,21,18,39
251,1,27,14,16,30
252,1,27,18,14,32
253,1,27,22,12,34
254,1,27,21,19,40
255,1,27,24,34,58
256,1,27,47,27,74
257,1,27,176,210,386
258,1,27,0,3,3
259,1,27,368,369,737
260,1,27,15,12,27
261,1,27,14,15,29
262,1,27,20,15,35
263,1,27,24,21,45
264,1,27,0,3,3
265,1,27,6,3,9
266,1,27,19,38,57
267,1,27,2,1,3
268,1,27,8,18,26
269,1,27,18,30,48
270,1,27,0,0,0
271,1,27,1,4,5
272,1,27,80,170,250
273,1,27,48,50,98
274,1,27,29,19,48
275,1,27,25,12,37
276,1,27,5,13,18
277,1,27,53,23,76
278,1,27,6,5,11
279,1,27,44,54,98
280,1,27,2,3,5
281,1,27,8,11,19
282,1,27,0,1,1
283,1,27,118,22,140
284,1,27,16,20,36
285,1,27,0,3,3
286,1,27,18,26,44
287,1,27,20,15,35
288,1,27,2,5,7
289,1,27,52,38,90
290,1,27,0,0,0
291,1,27,15,6,21
292,1,27,10,15,25
293,1,27,0,0,0
294,1,27,46,25,71
295,1,27,12,13,25
296,1,27,44,59,103
297,1,27,19,30,49
298,1,27,19,23,42
299,1,27,41,42,83
300,1,27,24,10,34
301,1,27,20,29,49
302,1,27,19,14,33
303,1,27,13,6,19
304,1,27,1,0,1
305,1,27,2,11,13
306,1,27,13,15,28
307,1,27,1,5,6
308,1,27,19,10,29
309,1,27,37,43,80
310,1,27,34,28,62
311,1,27,15,6,21
312,1,27,14,8,22
313,1,27,24,50,74
314,1,27,1,3,4
315,1,27,78,40,118
316,1,27,68,91,159
317,1,27,23,34,57
318,1,27,38,44,82
319,1,27,1,1,2
320,1,27,40,38,78
321,1,27,4,4,8
322,1,27,20,17,37
323,1,27,1,3,4
324,1,27,27,60,87
325,1,27,71,66,137
326,1,27,7,9,16
327,1,27,43,46,89
328,1,27,46,108,154
329,1,27,7,15,22
330,1,27,36,25,61
331,1,27,305,417,722
332,1,27,11,5,16
333,1,27,53,85,138
334,1,27,60,62,122
335,1,27,55,55,110
336,1,27,49,35,84
337,1,27,17,10,27
338,1,27,47,23,70
339,1,27,13,8,21
340,1,27,1,5,6
341,1,27,13,9,22
342,1,27,15,14,29
343,1,27,8,16,24
344,1,27,106,130,236
345,1,27,67,53,120
346,1,27,41,37,78
347,1,27,31,22,53
348,1,27,18,20,38
349,1,27,66,90,156
350,1,27,29,11,40
351,1,27,30,22,52
352,1,27,17,16,33
353,1,27,43,58,101
354,1,27,12,5,17
355,1,27,21,20,41
356,1,27,61,50,111
357,1,27,2,6,8
358,1,27,24,13,37
359,1,27,32,36,68
360,1,27,47,27,74
361,1,27,19,13,32
362,1,27,57,47,104
363,1,27,20,16,36
364,1,27,47,20,67
365,1,27,28,39,67
366,1,27,45,17,62
367,1,27,46,28,74
368,1,27,7,9,16
369,1,27,22,13,35
370,1,27,5,9,14
371,1,27,48,24,72
372,1,27,26,39,65
373,1,27,14,8,22
374,1,27,52,53,105
375,1,27,16,9,25
376,1,27,22,32,54
377,1,27,32,24,56
378,1,27,16,15,31
379,1,27,34,19,53
380,1,27,24,18,42
381,1,27,4,9,13
382,1,27,40,72,112
383,1,27,22,34,56
384,1,27,41,35,76
385,1,27,13,11,24
386,1,27,21,12,33
387,1,27,13,11,24
388,1,27,70,77,147
389,1,27,0,0,0
390,1,27,170,304,474
391,1,27,14,6,20
392,1,27,18,25,43
393,1,27,85,70,155
394,1,27,48,43,91
395,1,27,54,60,114
396,1,27,29,31,60
397,1,27,18,10,28
398,1,27,31,32,63
399,1,27,13,17,30
400,1,27,13,16,29
401,1,27,15,17,32
402,1,27,14,24,38
403,1,27,59,43,102
404,1,27,1,10,11
405,1,27,167,181,348
406,1,27,59,51,110
407,1,27,3,7,10
408,1,27,61,58,119
409,1,27,11,20,31
410,1,27,14,8,22
411,1,27,57,34,91
412,1,27,0,1,1
413,1,27,5,10,15
414,1,27,3,8,11
415,1,27,12,23,35
416,1,27,35,21,56
417,1,27,4,7,11
418,1,27,18,27,45
419,1,27,10,24,34
420,1,27,29,52,81
421,1,27,50,31,81
422,1,27,109,108,217
423,1,27,1,2,3
424,1,27,0,2,2
0,1,30,60,82,142
1,1,30,16,9,25
2,1,30,47,36,83
3,1,30,28,27,55
4,1,30,31,25,56
5,1,30,31,37,68
6,1,30,20,20,40
7,1,30,42,31,73
8,1,30,39,28,67
9,1,30,27,27,54
10,1,30,53,31,84
11,1,30,18,9,27
12,1,30,21,10,31
13,1,30,53,30,83
14,1,30,22,15,37
15,1,30,63,71,134
16,1,30,74,76,150
17,1,30,19,27,46
18,1,30,37,29,66
19,1,30,21,23,44
20,1,30,18,17,35
21,1,30,68,65,133
22,1,30,8,13,21
23,1,30,59,48,107
24,1,30,42,24,66
25,1,30,22,25,47
26,1,30,51,59,110
27,1,30,29,17,46
28,1,30,49,31,80
29,1,30,31,25,56
30,1,30,27,26,53
31,1,30,32,14,46
32,1,30,84,90,174
33,1,30,209,172,381
34,1,30,14,18,32
35,1,30,30,26,56
36,1,30,48,24,72
37,1,30,11,9,20
38,1,30,11,9,20
39,1,30,36,61,97
40,1,30,15,9,24
41,1,30,14,21,35
42,1,30,41,36,77
43,1,30,18,23,41
44,1,30,9,9,18
45,1,30,19,10,29
46,1,30,45,34,79
47,1,30,9,8,17
48,1,30,40,24,64
49,1,30,49,45,94
50,1,30,14,22,36
51,1,30,31,22,53
52,1,30,39,42,81
53,1,30,0,0,0
54,1,30,8,12,20
55,1,30,65,94,159
56,1,30,8,6,14
57,1,30,35,46,81
58,1,30,47,54,101
59,1,30,141,173,314
60,1,30,24,24,48
61,1,30,32,35,67
62,1,30,38,39,77
63,1,30,33,37,70
64,1,30,68,71,139
65,1,30,14,21,35
66,1,30,8,8,16
67,1,30,59,11,70
68,1,30,59,41,100
69,1,30,46,131,177
70,1,30,36,28,64
71,1,30,56,82,138
72,1,30,8,17,25
73,1,30,35,46,81
74,1,30,23,23,46
75,1,30,15,24,39
76,1,30,17,28,45
77,1,30,34,37,71
78,1,30,27,20,47
79,1,30,16,10,26
80,1,30,14,13,27
81,1,30,11,11,22
82,1,30,26,21,47
83,1,30,28,39,67
84,1,30,21,15,36
85,1,30,18,25,43
86,1,30,13,7,20
87,1,30,32,24,56
88,1,30,9,19,28
89,1,30,19,21,40
90,1,30,54,50,104
91,1,30,78,57,135
92,1,30,13,18,31
93,1,30,25,27,52
94,1,30,11,11,22
95,1,30,2,8,10
96,1,30,56,73,129
97,1,30,29,26,55
98,1,30,13,7,20
99,1,30,47,38,85
100,1,30,37,20,57
101,1,30,32,31,63
102,1,30,37,43,80
103,1,30,63,124,187
104,1,30,28,41,69
105,1,30,30,24,54
106,1,30,25,17,42
107,1,30,29,30,59
108,1,30,40,30,70
109,1,30,20,24,44
110,1,30,35,44,79
111,1,30,58,33,91
112,1,30,16,25,41
113,1,30,21,27,48
114,1,30,14,17,31
115,1,30,40,51,91
116,1,30,24,21,45
117,1,30,28,17,45
118,1,30,7,11,18
119,1,30,28,24,52
120,1,30,15,15,30
121,1,30,40,37,77
122,1,30,12,15,27
123,1,30,77,73,150
124,1,30,0,1,1
125,1,30,20,14,34
126,1,30,20,13,33
127,1,30,11,21,32
128,1,30,8,10,18
129,1,30,20,17,37
130,1,30,26,31,57
131,1,30,44,32,76
132,1,30,37,35,72
133,1,30,15,27,42
134,1,30,30,24,54
135,1,30,37,33,70
136,1,30,24,21,45
137,1,30,2,0,2
138,1,30,24,31,55
139,1,30,6,16,22
140,1,30,50,55,105
141,1,30,81,72,153
142,1,30,52,48,100
143,1,30,28,26,54
144,1,30,12,14,26
145,1,30,42,47,89
146,1,30,19,36,55
147,1,30,6,12,18
148,1,30,8,12,20
149,1,30,26,27,53
150,1,30,0,2,2
151,1,30,17,9,26
152,1,30,36,39,75
153,1,30,12,15,27
154,1,30,47,48,95
155,1,30,92,97,189
156,1,30,18,35,53
157,1,30,19,16,35
158,1,30,17,16,33
159,1,30,16,20,36
160,1,30,9,11,20
161,1,30,38,32,70
162,1,30,5,7,12
163,1,30,18,15,33
164,1,30,12,12,24
165,1,30,32,56,88
166,1,30,55,59,114
167,1,30,10,16,26
168,1,30,56,104,160
169,1,30,11,6,17
170,1,30,109,78,187
171,1,30,25,27,52
172,1,30,15,16,31
173,1,30,91,80,171
174,1,30,21,27,48
175,1,30,23,36,59
176,1,30,15,12,27
177,1,30,28,22,50
178,1,30,23,47,70
179,1,30,10,16,26
180,1,30,18,9,27
181,1,30,44,42,86
182,1,30,39,26,65
183,1,30,25,25,50
184,1,30,41,72,113
185,1,30,24,15,39
186,1,30,80,86,166
187,1,30,43,45,88
188,1,30,36,40,76
189,1,30,1,4,5
190,1,30,14,14,28
191,1,30,29,39,68
192,1,30,12,15,27
193,1,30,29,22,51
194,1,30,35,16,51
195,1,30,53,43,96
196,1,30,13,14,27
197,1,30,10,15,25
198,1,30,11,9,20
199,1,30,0,0,0
200,1,30,11,16,27
201,1,30,74,43,117
202,1,30,0,1,1
203,1,30,65,64,129
204,1,30,73,84,157
205,1,30,13,16,29
206,1,30,3,4,7
207,1,30,27,23,50
208,1,30,0,1,1
209,1,30,159,129,288
210,1,30,4,6,10
211,1,30,29,25,54
212,1,30,0,1,1
213,1,30,27,30,57
214,1,30,35,12,47
215,1,30,146,142,288
216,1,30,0,10,10
217,1,30,9,7,16
218,1,30,24,35,59
219,1,30,25,34,59
220,1,30,6,12,18
221,1,30,49,52,101
222,1,30,59,62,121
223,1,30,27,31,58
224,1,30,3,9,12
225,1,30,2,3,5
226,1,30,83,84,167
227,1,30,1,0,1
228,1,30,19,17,36
229,1,30,4,10,14
230,1,30,27,21,48
231,1,30,59,30,89
232,1,30,23,12,35
233,1,30,39,30,69
234,1,30,15,19,34
235,1,30,0,0,0
236,1,30,53,31,84
237,1,30,36,50,86
238,1,30,25,18,43
239,1,30,11,6,17
240,1,30,33,31,64
241,1,30,17,28,45
242,1,30,25,38,63
243,1,30,30,33,63
244,1,30,24,22,46
245,1,30,39,26,65
246,1,30,10,11,21
247,1,30,19,24,43
248,1,30,53,38,91
249,1,30,72,52,124
250,1,30,22,15,37
251,1,30,16,24,40
252,1,30,10,10,20
253,1,30,17,12,29
254,1,30,34,32,66
255,1,30,20,25,45
256,1,30,43,30,73
257,1,30,171,174,345
258,1,30,0,0,0
259,1,30,344,376,720
260,1,30,20,14,34
261,1,30,142,142,284
262,1,30,14,13,27
263,1,30,21,24,45
264,1,30,1,1,2
265,1,30,0,4,4
266,1,30,25,23,48
267,1,30,1,2,3
268,1,30,7,14,21
269,1,30,21,44,65
270,1,30,0,2,2
271,1,30,2,3,5
272,1,30,64,174,238
273,1,30,69,55,124
274,1,30,26,15,41
275,1,30,19,14,33
276,1,30,4,11,15
277,1,30,34,42,76
278,1,30,10,13,23
279,1,30,47,53,100
280,1,30,5,4,9
281,1,30,5,9,14
282,1,30,1,0,1
283,1,30,140,42,182
284,1,30,26,21,47
285,1,30,0,1,1
286,1,30,17,31,48
287,1,30,22,23,45
288,1,30,2,2,4
289,1,30,56,63,119
290,1,30,1,0,1
291,1,30,12,15,27
292,1,30,13,14,27
293,1,30,0,0,0
294,1,30,40,21,61
295,1,30,17,20,37
296,1,30,69,80,149
297,1,30,34,43,77
298,1,30,24,15,39
299,1,30,62,69,131
300,1,30,26,7,33
301,1,30,13,17,30
302,1,30,13,13,26
303,1,30,17,6,23
304,1,30,1,0,1
305,1,30,2,5,7
306,1,30,24,15,39
307,1,30,0,3,3
308,1,30,20,9,29
309,1,30,53,55,108
310,1,30,44,37,81
311,1,30,4,12,16
312,1,30,18,21,39
313,1,30,39,43,82
314,1,30,1,2,3
315,1,30,83,79,162
316,1,30,74,84,158
317,1,30,18,22,40
318,1,30,34,49,83
319,1,30,2,3,5
320,1,30,43,43,86
321,1,30,0,2,2
322,1,30,20,12,32
323,1,30,1,1,2
324,1,30,22,35,57
325,1,30,82,58,140
326,1,30,11,11,22
327,1,30,46,29,75
328,1,30,83,104,187
329,1,30,15,23,38
330,1,30,30,22,52
331,1,30,394,422,816
332,1,30,8,4,12
333,1,30,42,74,116
334,1,30,60,61,121
335,1,30,72,59,131
336,1,30,34,21,55
337,1,30,17,14,31
338,1,30,24,19,43
339,1,30,19,10,29
340,1,30,3,7,10
341,1,30,6,9,15
342,1,30,21,19,40
343,1,30,12,15,27
344,1,30,113,109,222
345,1,30,78,52,130
346,1,30,39,33,72
347,1,30,33,23,56
348,1,30,26,32,58
349,1,30,60,97,157
350,1,30,21,20,41
351,1,30,17,11,28
352,1,30,18,14,32
353,1,30,66,59,125
354,1,30,7,10,17
355,1,30,29,24,53
356,1,30,51,62,113
357,1,30,0,8,8
358,1,30,17,11,28
359,1,30,24,27,51
360,1,30,29,25,54
361,1,30,19,15,34
362,1,30,65,41,106
363,1,30,17,11,28
364,1,30,44,22,66
365,1,30,41,39,80
366,1,30,49,22,71
367,1,30,28,19,47
368,1,30,12,10,22
369,1,30,20,16,36
370,1,30,5,5,10
371,1,30,30,27,57
372,1,30,42,33,75
373,1,30,13,13,26
374,1,30,47,56,103
375,1,30,14,17,31
376,1,30,43,36,79
377,1,30,44,39,83
378,1,30,18,18,36
379,1,30,35,13,48
380,1,30,25,19,44
381,1,30,6,4,10
382,1,30,76,73,149
383,1,30,20,63,83
384,1,30,39,22,61
385,1,30,6,10,16
386,1,30,32,14,46
387,1,30,13,14,27
388,1,30,37,30,67
389,1,30,0,1,1
390,1,30,249,290,539
391,1,30,14,8,22
392,1,30,15,19,34
393,1,30,73,74,147
394,1,30,52,45,97
395,1,30,70,85,155
396,1,30,34,24,58
397,1,30,17,9,26
398,1,30,31,47,78
399,1,30,17,10,27
400,1,30,14,17,31
401,1,30,17,14,31
402,1,30,17,27,44
403,1,30,46,29,75
404,1,30,3,5,8
405,1,30,159,161,320
406,1,30,62,72,134
407,1,30,1,6,7
408,1,30,49,43,92
409,1,30,11,14,25
410,1,30,18,31,49
411,1,30,35,38,73
412,1,30,1,4,5
413,1,30,5,14,19
414,1,30,10,13,23
415,1,30,23,18,41
416,1,30,33,22,55
417,1,30,8,14,22
418,1,30,47,31,78
419,1,30,32,23,55
420,1,30,25,55,80
421,1,30,56,37,93
422,1,30,120,132,252
423,1,30,0,9,9
424,1,30,2,1,3
0,1,33,47,94,141
1,1,33,11,20,31
2,1,33,63,51,114
3,1,33,32,26,58
4,1,33,28,34,62
5,1,33,46,46,92
6,1,33,15,22,37
7,1,33,25,36,61
8,1,33,43,32,75
9,1,33,23,19,42
10,1,33,53,41,94
11,1,33,20,18,38
12,1,33,20,12,32
13,1,33,46,42,88
14,1,33,17,18,35
15,1,33,90,65,155
16,1,33,59,89,148
17,1,33,32,35,67
18,1,33,46,29,75
19,1,33,28,18,46
20,1,33,15,11,26
21,1,33,105,72,177
22,1,33,10,19,29
23,1,33,61,45,106
24,1,33,53,32,85
25,1,33,15,23,38
26,1,33,47,55,102
27,1,33,28,23,51
28,1,33,42,40,82
29,1,33,33,41,74
30,1,33,28,24,52
31,1,33,28,20,48
32,1,33,92,83,175
33,1,33,186,221,407
34,1,33,19,18,37
35,1,33,34,34,68
36,1,33,53,40,93
37,1,33,6,7,13
38,1,33,9,9,18
39,1,33,47,52,99
40,1,33,12,13,25
41,1,33,16,18,34
42,1,33,26,37,63
43,1,33,22,26,48
44,1,33,9,15,24
45,1,33,23,19,42
46,1,33,47,26,73
47,1,33,6,10,16
48,1,33,44,33,77
49,1,33,45,43,88
50,1,33,14,20,34
51,1,33,30,26,56
52,1,33,35,43,78
53,1,33,0,0,0
54,1,33,12,10,22
55,1,33,95,106,201
56,1,33,9,9,18
57,1,33,46,48,94
58,1,33,37,42,79
59,1,33,193,174,367
60,1,33,34,14,48
61,1,33,36,38,74
62,1,33,33,35,68
63,1,33,38,43,81
64,1,33,74,60,134
65,1,33,14,10,24
66,1,33,10,9,19
67,1,33,24,20,44
68,1,33,42,50,92
69,1,33,48,61,109
70,1,33,32,28,60
71,1,33,69,84,153
72,1,33,7,14,21
73,1,33,48,58,106
74,1,33,26,16,42
75,1,33,29,19,48
76,1,33,21,32,53
77,1,33,24,41,65
78,1,33,25,22,47
79,1,33,19,10,29
80,1,33,25,25,50
81,1,33,14,14,28
82,1,33,25,17,42
83,1,33,48,59,107
84,1,33,13,10,23
85,1,33,25,35,60
86,1,33,20,11,31
87,1,33,32,50,82
88,1,33,13,23,36
89,1,33,20,18,38
90,1,33,44,60,104
91,1,33,81,52,133
92,1,33,12,19,31
93,1,33,25,35,60
94,1,33,16,7,23
95,1,33,4,8,12
96,1,33,52,70,122
97,1,33,34,31,65
98,1,33,19,12,31
99,1,33,39,31,70
100,1,33,20,33,53
101,1,33,49,45,94
102,1,33,24,28,52
103,1,33,71,69,140
104,1,33,20,37,57
105,1,33,32,24,56
106,1,33,9,16,25
107,1,33,40,24,64
108,1,33,29,23,52
109,1,33,12,20,32
110,1,33,34,36,70
111,1,33,47,49,96
112,1,33,20,13,33
113,1,33,17,29,46
114,1,33,21,19,40
115,1,33,53,57,110
116,1,33,33,17,50
117,1,33,15,20,35
118,1,33,14,9,23
119,1,33,39,29,68
120,1,33,11,15,26
121,1,33,35,37,72
122,1,33,16,13,29
123,1,33,63,59,122
124,1,33,1,1,2
125,1,33,16,12,28
126,1,33,25,11,36
127,1,33,24,19,43
128,1,33,6,4,10
129,1,33,34,43,77
130,1,33,32,30,62
131,1,33,45,38,83
132,1,33,27,34,61
133,1,33,9,20,29
134,1,33,32,23,55
135,1,33,28,28,56
136,1,33,16,23,39
137,1,33,6,6,12
138,1,33,27,29,56
139,1,33,11,13,24
140,1,33,64,65,129
141,1,33,80,81,161
142,1,33,54,29,83
143,1,33,14,31,45
144,1,33,11,6,17
145,1,33,25,26,51
146,1,33,20,37,57
147,1,33,6,6,12
148,1,33,8,9,17
149,1,33,26,29,55
150,1,33,2,8,10
151,1,33,18,19,37
152,1,33,47,50,97
153,1,33,9,16,25
154,1,33,73,79,152
155,1,33,83,69,152
156,1,33,24,37,61
157,1,33,22,19,41
158,1,33,12,10,22
159,1,33,24,38,62
160,1,33,8,16,24
161,1,33,41,30,71
162,1,33,1,6,7
163,1,33,18,16,34
164,1,33,12,19,31
165,1,33,39,46,85
166,1,33,45,67,112
167,1,33,5,16,21
168,1,33,81,90,171
169,1,33,6,12,18
170,1,33,92,72,164
171,1,33,26,27,53
172,1,33,15,14,29
173,1,33,64,62,126
174,1,33,19,33,52
175,1,33,29,17,46
176,1,33,10,12,22
177,1,33,22,10,32
178,1,33,25,40,65
179,1,33,11,18,29
180,1,33,11,11,22
181,1,33,34,31,65
182,1,33,60,29,89
183,1,33,32,26,58
184,1,33,63,84,147
185,1,33,20,17,37
186,1,33,88,85,173
187,1,33,55,58,113
188,1,33,44,43,87
189,1,33,2,3,5
190,1,33,15,23,38
191,1,33,32,33,65
192,1,33,21,10,31
193,1,33,17,25,42
194,1,33,29,27,56
195,1,33,40,54,94
196,1,33,19,19,38
197,1,33,11,18,29
198,1,33,20,12,32
199,1,33,1,0,1
200,1,33,11,14,25
201,1,33,62,40,102
202,1,33,0,1,1
203,1,33,71,63,134
204,1,33,96,108,204
205,1,33,7,11,18
206,1,33,3,9,12
207,1,33,26,30,56
208,1,33,0,2,2
209,1,33,118,116,234
210,1,33,7,10,17
211,1,33,38,34,72
212,1,33,0,0,0
213,1,33,17,21,38
214,1,33,20,15,35
215,1,33,129,105,234
216,1,33,1,2,3
217,1,33,11,11,22
218,1,33,29,40,69
219,1,33,29,44,73
220,1,33,11,19,30
221,1,33,46,54,100
222,1,33,77,91,168
223,1,33,35,23,58
224,1,33,6,4,10
225,1,33,2,8,10
226,1,33,89,66,155
227,1,33,0,3,3
228,1,33,28,16,44
229,1,33,6,13,19
230,1,33,25,21,46
231,1,33,46,28,74
232,1,33,33,21,54
233,1,33,54,46,100
234,1,33,40,27,67
235,1,33,1,2,3
236,1,33,49,36,85
237,1,33,40,69,109
238,1,33,28,25,53
239,1,33,10,9,19
240,1,33,45,45,90
241,1,33,21,31,52
242,1,33,42,37,79
243,1,33,40,38,78
244,1,33,38,30,68
245,1,33,38,31,69
246,1,33,5,12,17
247,1,33,32,38,70
248,1,33,57,43,100
249,1,33,70,48,118
250,1,33,21,17,38
251,1,33,28,36,64
252,1,33,16,17,33
253,1,33,21,11,32
254,1,33,34,28,62
255,1,33,25,26,51
256,1,33,47,23,70
257,1,33,138,204,342
258,1,33,0,0,0
259,1,33,340,413,753
260,1,33,18,16,34
261,1,33,135,134,269
262,1,33,8,16,24
263,1,33,25,22,47
264,1,33,1,2,3
265,1,33,1,1,2
266,1,33,30,29,59
267,1,33,3,1,4
268,1,33,10,13,23
269,1,33,28,48,76
270,1,33,0,0,0
271,1,33,3,6,9
272,1,33,72,175,247
273,1,33,100,61,161
274,1,33,23,15,38
275,1,33,20,14,34
276,1,33,5,16,21
277,1,33,38,37,75
278,1,33,5,3,8
279,1,33,58,52,110
280,1,33,2,0,2
281,1,33,10,18,28
282,1,33,1,0,1
283,1,33,122,37,159
284,1,33,22,22,44
285,1,33,0,6,6
286,1,33,31,33,64
287,1,33,19,42,61
288,1,33,5,1,6
289,1,33,89,76,165
290,1,33,0,0,0
291,1,33,22,17,39
292,1,33,12,14,26
293,1,33,0,1,1
294,1,33,42,27,69
295,1,33,6,8,14
296,1,33,67,80,147
297,1,33,39,60,99
298,1,33,16,15,31
299,1,33,65,64,129
300,1,33,22,14,36
301,1,33,26,17,43
302,1,33,19,18,37
303,1,33,12,13,25
304,1,33,0,2,2
305,1,33,1,13,14
306,1,33,15,16,31
307,1,33,0,3,3
308,1,33,14,17,31
309,1,33,59,76,135
310,1,33,37,25,62
311,1,33,17,20,37
312,1,33,20,16,36
313,1,33,34,32,66
314,1,33,1,3,4
315,1,33,78,75,153
316,1,33,84,68,152
317,1,33,13,23,36
318,1,33,45,40,85
319,1,33,1,3,4
320,1,33,45,33,78
321,1,33,2,4,6
322,1,33,13,11,24
323,1,33,0,2,2
324,1,33,34,57,91
325,1,33,104,61,165
326,1,33,14,14,28
327,1,33,40,27,67
328,1,33,63,81,144
329,1,33,15,17,32
330,1,33,27,23,50
331,1,33,332,323,655
332,1,33,11,8,19
333,1,33,46,73,119
334,1,33,70,69,139
335,1,33,45,43,88
336,1,33,65,36,101
337,1,33,20,9,29
338,1,33,25,24,49
339,1,33,8,15,23
340,1,33,5,8,13
341,1,33,23,16,39
342,1,33,22,34,56
343,1,33,12,15,27
344,1,33,118,92,210
345,1,33,53,63,116
346,1,33,41,26,67
347,1,33,31,25,56
348,1,33,24,30,54
349,1,33,57,77,134
350,1,33,22,21,43
351,1,33,18,22,40
352,1,33,12,14,26
353,1,33,74,59,133
354,1,33,10,14,24
355,1,33,22,13,35
356,1,33,55,53,108
357,1,33,6,11,17
358,1,33,28,17,45
359,1,33,22,22,44
360,1,33,46,32,78
361,1,33,14,8,22
362,1,33,70,50,120
363,1,33,21,13,34
364,1,33,43,33,76
365,1,33,35,50,85
366,1,33,29,16,45
367,1,33,29,29,58
368,1,33,5,10,15
369,1,33,23,14,37
370,1,33,8,3,11
371,1,33,48,34,82
372,1,33,40,35,75
373,1,33,13,11,24
374,1,33,44,36,80
375,1,33,17,15,32
376,1,33,56,55,111
377,1,33,39,48,87
378,1,33,20,34,54
379,1,33,33,22,55
380,1,33,21,20,41
381,1,33,4,11,15
382,1,33,52,54,106
383,1,33,28,29,57
384,1,33,31,29,60
385,1,33,13,13,26
386,1,33,19,21,40
387,1,33,12,8,20
388,1,33,29,28,57
389,1,33,0,0,0
390,1,33,254,263,517
391,1,33,14,13,27
392,1,33,3,11,14
393,1,33,68,87,155
394,1,33,46,35,81
395,1,33,64,62,126
396,1,33,23,16,39
397,1,33,13,12,25
398,1,33,25,37,62
399,1,33,24,10,34
400,1,33,16,12,28
401,1,33,15,14,29
402,1,33,12,12,24
403,1,33,51,38,89
404,1,33,4,7,11
405,1,33,143,182,325
406,1,33,68,51,119
407,1,33,4,7,11
408,1,33,47,44,91
409,1,33,5,10,15
410,1,33,18,23,41
411,1,33,38,18,56
412,1,33,1,3,4
413,1,33,3,7,10
414,1,33,5,8,13
415,1,33,22,26,48
416,1,33,34,24,58
417,1,33,6,6,12
418,1,33,29,31,60
419,1,33,36,24,60
420,1,33,37,47,84
421,1,33,66,61,127
422,1,33,104,117,221
423,1,33,3,7,10
424,1,33,5,6,11
0,1,36,71,72,143
1,1,36,15,9,24
2,1,36,59,48,107
3,1,36,32,36,68
4,1,36,31,26,57
5,1,36,58,56,114
6,1,36,15,22,37
7,1,36,27,28,55
8,1,36,37,36,73
9,1,36,19,21,40
10,1,36,56,41,97
11,1,36,22,15,37
12,1,36,22,14,36
13,1,36,49,28,77
14,1,36,24,24,48
15,1,36,68,65,133
16,1,36,66,62,128
17,1,36,38,34,72
18,1,36,28,28,56
19,1,36,23,20,43
20,1,36,20,18,38
21,1,36,90,79,169
22,1,36,12,20,32
23,1,36,37,38,75
24,1,36,41,27,68
25,1,36,30,20,50
26,1,36,58,57,115
27,1,36,19,33,52
28,1,36,49,38,87
29,1,36,45,44,89
30,1,36,34,24,58
31,1,36,25,25,50
32,1,36,94,75,169
33,1,36,216,234,450
34,1,36,18,19,37
35,1,36,23,36,59
36,1,36,54,34,88
37,1,36,14,10,24
38,1,36,6,12,18
39,1,36,34,49,83
40,1,36,21,16,37
41,1,36,23,26,49
42,1,36,38,30,68
43,1,36,20,35,55
44,1,36,8,7,15
45,1,36,17,11,28
46,1,36,29,36,65
47,1,36,4,6,10
48,1,36,43,33,76
49,1,36,33,36,69
50,1,36,7,11,18
51,1,36,33,40,73
52,1,36,48,42,90
53,1,36,0,0,0
54,1,36,11,8,19
55,1,36,98,88,186
56,1,36,4,9,13
57,1,36,50,50,100
58,1,36,47,51,98
59,1,36,184,182,366
60,1,36,21,23,44
61,1,36,33,28,61
62,1,36,38,27,65
63,1,36,40,45,85
64,1,36,84,70,154
65,1,36,22,29,51
66,1,36,10,12,22
67,1,36,27,27,54
68,1,36,77,59,136
69,1,36,69,97,166
70,1,36,40,40,80
71,1,36,64,74,138
72,1,36,14,24,38
73,1,36,65,48,113
74,1,36,34,19,53
75,1,36,13,19,32
76,1,36,16,33,49
77,1,36,31,32,63
78,1,36,25,30,55
79,1,36,19,16,35
80,1,36,26,25,51
81,1,36,7,13,20
82,1,36,24,21,45
83,1,36,47,61,108
84,1,36,12,18,30
85,1,36,25,27,52
86,1,36,21,10,31
87,1,36,45,51,96
88,1,36,11,13,24
89,1,36,26,24,50
90,1,36,64,67,131
91,1,36,83,61,144
92,1,36,10,27,37
93,1,36,24,24,48
94,1,36,10,8,18
95,1,36,6,6,12
96,1,36,76,80,156
97,1,36,34,28,62
98,1,36,13,13,26
99,1,36,64,44,108
100,1,36,47,46,93
101,1,36,43,38,81
102,1,36,27,38,65
103,1,36,70,64,134
104,1,36,34,45,79
105,1,36,19,26,45
106,1,36,17,19,36
107,1,36,23,22,45
108,1,36,49,43,92
109,1,36,23,26,49
110,1,36,43,39,82
111,1,36,64,48,112
112,1,36,14,22,36
113,1,36,21,28,49
114,1,36,24,17,41
115,1,36,32,51,83
116,1,36,20,28,48
117,1,36,20,16,36
118,1,36,15,19,34
119,1,36,36,43,79
120,1,36,16,17,33
121,1,36,34,36,70
122,1,36,15,7,22
123,1,36,63,59,122
124,1,36,1,1,2
125,1,36,22,15,37
126,1,36,18,16,34
127,1,36,18,23,41
128,1,36,3,7,10
129,1,36,35,41,76
130,1,36,33,30,63
131,1,36,61,64,125
132,1,36,33,36,69
133,1,36,13,22,35
134,1,36,43,36,79
135,1,36,28,31,59
136,1,36,11,19,30
137,1,36,1,2,3
138,1,36,31,29,60
139,1,36,11,19,30
140,1,36,50,61,111
141,1,36,82,72,154
142,1,36,41,40,81
143,1,36,20,45,65
144,1,36,5,5,10
145,1,36,37,48,85
146,1,36,16,31,47
147,1,36,8,13,21
148,1,36,8,10,18
149,1,36,21,31,52
150,1,36,0,5,5
151,1,36,23,11,34
152,1,36,47,52,99
153,1,36,9,25,34
154,1,36,56,70,126
155,1,36,74,57,131
156,1,36,39,37,76
157,1,36,17,17,34
158,1,36,18,10,28
159,1,36,8,22,30
160,1,36,17,11,28
161,1,36,42,29,71
162,1,36,3,10,13
163,1,36,9,12,21
164,1,36,13,15,28
165,1,36,36,65,101
166,1,36,62,63,125
167,1,36,11,7,18
168,1,36,84,79,163
169,1,36,16,13,29
170,1,36,86,85,171
171,1,36,13,32,45
172,1,36,30,14,44
173,1,36,63,68,131
174,1,36,28,30,58
175,1,36,22,26,48
176,1,36,5,9,14
177,1,36,18,25,43
178,1,36,51,36,87
179,1,36,18,19,37
180,1,36,18,14,32
181,1,36,34,38,72
182,1,36,34,31,65
183,1,36,39,32,71
184,1,36,60,64,124
185,1,36,11,14,25
186,1,36,76,90,166
187,1,36,55,63,118
188,1,36,57,48,105
189,1,36,0,2,2
190,1,36,20,34,54
191,1,36,38,34,72
192,1,36,12,6,18
193,1,36,38,35,73
194,1,36,30,20,50
195,1,36,34,33,67
196,1,36,16,11,27
197,1,36,9,10,19
198,1,36,23,7,30
199,1,36,0,0,0
200,1,36,20,12,32
201,1,36,71,45,116
202,1,36,0,0,0
203,1,36,71,66,137
204,1,36,111,110,221
205,1,36,10,21,31
206,1,36,1,1,2
207,1,36,47,29,76
208,1,36,1,3,4
209,1,36,123,107,230
210,1,36,4,8,12
211,1,36,56,34,90
212,1,36,0,0,0
213,1,36,16,25,41
214,1,36,36,11,47
215,1,36,114,126,240
216,1,36,1,3,4
217,1,36,6,7,13
218,1,36,34,33,67
219,1,36,38,21,59
220,1,36,14,18,32
221,1,36,57,51,108
222,1,36,104,96,200
223,1,36,29,22,51
224,1,36,6,6,12
225,1,36,2,0,2
226,1,36,65,83,148
227,1,36,1,2,3
228,1,36,19,12,31
229,1,36,1,5,6
230,1,36,18,19,37
231,1,36,41,21,62
232,1,36,27,19,46
233,1,36,56,50,106
234,1,36,37,26,63
235,1,36,1,5,6
236,1,36,52,36,88
237,1,36,44,44,88
238,1,36,20,29,49
239,1,36,11,12,23
240,1,36,54,48,102
241,1,36,19,29,48
242,1,36,50,42,92
243,1,36,40,38,78
244,1,36,30,37,67
245,1,36,30,26,56
246,1,36,9,7,16
247,1,36,48,32,80
248,1,36,46,45,91
249,1,36,71,52,123
250,1,36,30,28,58
251,1,36,20,24,44
252,1,36,16,12,28
253,1,36,18,20,38
254,1,36,30,28,58
255,1,36,26,17,43
256,1,36,46,27,73
257,1,36,155,203,358
258,1,36,0,0,0
259,1,36,335,452,787
260,1,36,26,14,40
261,1,36,132,130,262
262,1,36,8,14,22
263,1,36,37,44,81
264,1,36,2,4,6
265,1,36,2,4,6
266,1,36,17,22,39
267,1,36,3,3,6
268,1,36,9,12,21
269,1,36,44,43,87
270,1,36,0,1,1
271,1,36,2,4,6
272,1,36,78,208,286
273,1,36,93,68,161
274,1,36,25,17,42
275,1,36,18,9,27
276,1,36,7,16,23
277,1,36,35,29,64
278,1,36,5,4,9
279,1,36,67,51,118
280,1,36,7,7,14
281,1,36,15,11,26
282,1,36,0,0,0
283,1,36,145,57,202
284,1,36,23,24,47
285,1,36,2,1,3
286,1,36,19,16,35
287,1,36,25,38,63
288,1,36,3,3,6
289,1,36,82,86,168
290,1,36,0,1,1
291,1,36,21,23,44
292,1,36,16,10,26
293,1,36,0,1,1
294,1,36,39,30,69
295,1,36,6,18,24
296,1,36,80,75,155
297,1,36,39,61,100
298,1,36,27,11,38
299,1,36,67,62,129
300,1,36,20,7,27
301,1,36,19,11,30
302,1,36,18,18,36
303,1,36,22,14,36
304,1,36,0,1,1
305,1,36,8,8,16
306,1,36,19,19,38
307,1,36,0,3,3
308,1,36,17,15,32
309,1,36,67,80,147
310,1,36,34,29,63
311,1,36,15,20,35
312,1,36,18,16,34
313,1,36,22,27,49
314,1,36,2,2,4
315,1,36,60,60,120
316,1,36,73,80,153
317,1,36,18,21,39
318,1,36,50,53,103
319,1,36,1,2,3
320,1,36,37,48,85
321,1,36,2,3,5
322,1,36,18,30,48
323,1,36,0,7,7
324,1,36,36,58,94
325,1,36,81,57,138
326,1,36,15,10,25
327,1,36,37,41,78
328,1,36,71,61,132
329,1,36,17,23,40
330,1,36,24,23,47
331,1,36,320,387,707
332,1,36,10,6,16
333,1,36,61,76,137
334,1,36,70,59,129
335,1,36,60,49,109
336,1,36,60,50,110
337,1,36,17,16,33
338,1,36,36,29,65
339,1,36,10,13,23
340,1,36,3,4,7
341,1,36,14,12,26
342,1,36,19,28,47
343,1,36,21,16,37
344,1,36,98,91,189
345,1,36,74,57,131
346,1,36,31,22,53
347,1,36,32,21,53
348,1,36,35,22,57
349,1,36,73,67,140
350,1,36,18,16,34
351,1,36,18,25,43
352,1,36,9,16,25
353,1,36,47,44,91
354,1,36,13,12,25
355,1,36,22,12,34
356,1,36,66,64,130
357,1,36,6,8,14
358,1,36,23,16,39
359,1,36,19,24,43
360,1,36,34,31,65
361,1,36,13,15,28
362,1,36,43,47,90
363,1,36,18,19,37
364,1,36,45,36,81
365,1,36,33,39,72
366,1,36,48,24,72
367,1,36,35,25,60
368,1,36,6,16,22
369,1,36,18,21,39
370,1,36,4,4,8
371,1,36,44,26,70
372,1,36,39,33,72
373,1,36,12,11,23
374,1,36,40,34,74
375,1,36,17,17,34
376,1,36,39,39,78
377,1,36,44,51,95
378,1,36,15,16,31
379,1,36,19,21,40
380,1,36,30,20,50
381,1,36,4,6,10
382,1,36,52,69,121
383,1,36,27,29,56
384,1,36,46,34,80
385,1,36,5,11,16
386,1,36,26,23,49
387,1,36,5,6,11
388,1,36,19,19,38
389,1,36,0,0,0
390,1,36,246,260,506
391,1,36,18,14,32
392,1,36,11,13,24
393,1,36,80,75,155
394,1,36,30,26,56
395,1,36,64,70,134
396,1,36,23,26,49
397,1,36,17,12,29
398,1,36,35,45,80
399,1,36,11,21,32
400,1,36,16,15,31
401,1,36,20,9,29
402,1,36,11,27,38
403,1,36,50,24,74
404,1,36,9,14,23
405,1,36,174,214,388
406,1,36,42,47,89
407,1,36,6,8,14
408,1,36,42,33,75
409,1,36,6,19,25
410,1,36,31,40,71
411,1,36,47,27,74
412,1,36,1,1,2
413,1,36,8,8,16
414,1,36,10,12,22
415,1,36,16,25,41
416,1,36,36,25,61
417,1,36,9,11,20
418,1,36,37,44,81
419,1,36,22,23,45
420,1,36,37,40,77
421,1,36,68,32,100
422,1,36,94,103,197
423,1,36,2,5,7
424,1,36,0,0,0
0,1,39,92,97,189
1,1,39,23,20,43
2,1,39,66,68,134
3,1,39,26,31,57
4,1,39,34,38,72
5,1,39,62,68,130
6,1,39,26,25,51
7,1,39,34,37,71
8,1,39,38,26,64
9,1,39,41,28,69
10,1,39,52,34,86
11,1,39,9,9,18
12,1,39,31,15,46
13,1,39,46,51,97
14,1,39,17,28,45
15,1,39,59,86,145
16,1,39,60,66,126
17,1,39,53,30,83
18,1,39,46,31,77
19,1,39,17,17,34
20,1,39,19,12,31
21,1,39,80,66,146
22,1,39,12,17,29
23,1,39,45,38,83
24,1,39,48,43,91
25,1,39,18,18,36
26,1,39,78,75,153
27,1,39,29,24,53
28,1,39,62,42,104
29,1,39,51,36,87
30,1,39,31,28,59
31,1,39,33,28,61
32,1,39,95,112,207
33,1,39,206,234,440
34,1,39,17,20,37
35,1,39,35,32,67
36,1,39,46,44,90
37,1,39,12,8,20
38,1,39,8,20,28
39,1,39,65,70,135
40,1,39,18,18,36
41,1,39,18,20,38
42,1,39,42,42,84
43,1,39,30,59,89
44,1,39,7,9,16
45,1,39,26,25,51
46,1,39,27,26,53
47,1,39,9,16,25
48,1,39,38,35,73
49,1,39,41,33,74
50,1,39,11,28,39
51,1,39,34,24,58
52,1,39,49,55,104
53,1,39,0,0,0
54,1,39,20,8,28
55,1,39,102,114,216
56,1,39,7,11,18
57,1,39,50,54,104
58,1,39,51,47,98
59,1,39,176,205,381
60,1,39,32,20,52
61,1,39,50,35,85
62,1,39,39,32,71
63,1,39,56,31,87
64,1,39,68,66,134
65,1,39,13,16,29
66,1,39,15,8,23
67,1,39,22,19,41
68,1,39,56,47,103
69,1,39,57,87,144
70,1,39,33,54,87
71,1,39,73,68,141
72,1,39,12,20,32
73,1,39,59,44,103
74,1,39,24,19,43
75,1,39,26,27,53
76,1,39,26,22,48
77,1,39,35,37,72
78,1,39,32,33,65
79,1,39,23,30,53
80,1,39,31,31,62
81,1,39,9,11,20
82,1,39,27,21,48
83,1,39,43,44,87
84,1,39,19,18,37
85,1,39,27,26,53
86,1,39,11,9,20
87,1,39,53,57,110
88,1,39,9,8,17
89,1,39,27,25,52
90,1,39,83,79,162
91,1,39,79,73,152
92,1,39,20,25,45
93,1,39,28,26,54
94,1,39,11,13,24
95,1,39,7,11,18
96,1,39,54,57,111
97,1,39,31,35,66
98,1,39,15,17,32
99,1,39,57,55,112
100,1,39,50,39,89
101,1,39,60,45,105
102,1,39,34,49,83
103,1,39,59,57,116
104,1,39,30,44,74
105,1,39,34,16,50
106,1,39,14,15,29
107,1,39,32,25,57
108,1,39,34,47,81
109,1,39,18,22,40
110,1,39,34,49,83
111,1,39,51,43,94
112,1,39,21,25,46
113,1,39,24,30,54
114,1,39,21,23,44
115,1,39,47,55,102
116,1,39,23,31,54
117,1,39,30,15,45
118,1,39,17,22,39
119,1,39,48,36,84
120,1,39,16,22,38
121,1,39,44,44,88
122,1,39,20,13,33
123,1,39,65,62,127
124,1,39,0,2,2
125,1,39,14,16,30
126,1,39,26,9,35
127,1,39,17,19,36
128,1,39,4,7,11
129,1,39,38,34,72
130,1,39,29,37,66
131,1,39,62,38,100
132,1,39,31,32,63
133,1,39,17,17,34
134,1,39,44,40,84
135,1,39,41,31,72
136,1,39,17,23,40
137,1,39,6,3,9
138,1,39,36,28,64
139,1,39,19,17,36
140,1,39,57,55,112
141,1,39,81,65,146
142,1,39,43,53,96
143,1,39,35,35,70
144,1,39,12,9,21
145,1,39,34,25,59
146,1,39,21,30,51
147,1,39,7,7,14
148,1,39,12,15,27
149,1,39,22,22,44
150,1,39,4,7,11
151,1,39,17,11,28
152,1,39,43,34,77
153,1,39,7,18,25
154,1,39,62,66,128
155,1,39,66,87,153
156,1,39,32,38,70
157,1,39,21,14,35
158,1,39,7,10,17
159,1,39,31,30,61
160,1,39,16,11,27
161,1,39,39,33,72
162,1,39,8,15,23
163,1,39,15,8,23
164,1,39,11,14,25
165,1,39,41,65,106
166,1,39,57,47,104
167,1,39,6,14,20
168,1,39,64,72,136
169,1,39,15,18,33
170,1,39,90,66,156
171,1,39,34,30,64
172,1,39,9,13,22
173,1,39,82,89,171
174,1,39,31,22,53
175,1,39,23,32,55
176,1,39,13,14,27
177,1,39,34,18,52
178,1,39,47,34,81
179,1,39,15,15,30
180,1,39,21,13,34
181,1,39,41,31,72
182,1,39,24,38,62
183,1,39,34,30,64
184,1,39,65,94,159
185,1,39,16,11,27
186,1,39,101,99,200
187,1,39,71,59,130
188,1,39,53,47,100
189,1,39,0,0,0
190,1,39,27,32,59
191,1,39,25,36,61
192,1,39,17,9,26
193,1,39,26,22,48
194,1,39,25,23,48
195,1,39,43,33,76
196,1,39,13,19,32
197,1,39,12,22,34
198,1,39,21,18,39
199,1,39,0,0,0
200,1,39,7,8,15
201,1,39,75,46,121
202,1,39,0,1,1
203,1,39,71,68,139
204,1,39,130,122,252
205,1,39,6,22,28
206,1,39,1,4,5
207,1,39,39,30,69
208,1,39,0,3,3
209,1,39,92,99,191
210,1,39,3,5,8
211,1,39,50,41,91
212,1,39,1,0,1
213,1,39,30,31,61
214,1,39,26,15,41
215,1,39,125,115,240
216,1,39,0,2,2
217,1,39,13,20,33
218,1,39,30,25,55
219,1,39,45,18,63
220,1,39,12,11,23
221,1,39,60,72,132
222,1,39,94,88,182
223,1,39,31,23,54
224,1,39,7,5,12
225,1,39,0,2,2
226,1,39,73,68,141
227,1,39,2,1,3
228,1,39,18,11,29
229,1,39,6,10,16
230,1,39,21,21,42
231,1,39,47,30,77
232,1,39,14,21,35
233,1,39,60,62,122
234,1,39,32,20,52
235,1,39,1,0,1
236,1,39,48,45,93
237,1,39,41,50,91
238,1,39,23,25,48
239,1,39,12,6,18
240,1,39,63,59,122
241,1,39,14,32,46
242,1,39,40,41,81
243,1,39,33,34,67
244,1,39,48,26,74
245,1,39,35,33,68
246,1,39,10,19,29
247,1,39,38,24,62
248,1,39,50,47,97
249,1,39,58,60,118
250,1,39,17,19,36
251,1,39,11,15,26
252,1,39,5,14,19
253,1,39,27,26,53
254,1,39,42,30,72
255,1,39,25,26,51
256,1,39,57,37,94
257,1,39,155,194,349
258,1,39,0,0,0
259,1,39,363,393,756
260,1,39,25,14,39
261,1,39,112,117,229
262,1,39,9,9,18
263,1,39,17,21,38
264,1,39,1,3,4
265,1,39,3,2,5
266,1,39,30,44,74
267,1,39,1,1,2
268,1,39,11,27,38
269,1,39,50,37,87
270,1,39,0,1,1
271,1,39,3,6,9
272,1,39,73,187,260
273,1,39,81,67,148
274,1,39,21,16,37
275,1,39,21,16,37
276,1,39,9,12,21
277,1,39,45,49,94
278,1,39,10,6,16
279,1,39,64,83,147
280,1,39,7,3,10
281,1,39,15,12,27
282,1,39,1,0,1
283,1,39,116,52,168
284,1,39,29,30,59
285,1,39,4,2,6
286,1,39,19,31,50
287,1,39,41,29,70
288,1,39,5,1,6
289,1,39,89,68,157
290,1,39,0,0,0
291,1,39,20,15,35
292,1,39,7,14,21
293,1,39,3,4,7
294,1,39,49,29,78
295,1,39,18,24,42
296,1,39,75,87,162
297,1,39,33,41,74
298,1,39,25,16,41
299,1,39,73,54,127
300,1,39,13,3,16
301,1,39,12,24,36
302,1,39,24,23,47
303,1,39,14,10,24
304,1,39,1,2,3
305,1,39,4,6,10
306,1,39,15,18,33
307,1,39,3,3,6
308,1,39,11,7,18
309,1,39,69,76,145
310,1,39,36,33,69
311,1,39,21,13,34
312,1,39,15,8,23
313,1,39,26,34,60
314,1,39,1,0,1
315,1,39,85,66,151
316,1,39,59,97,156
317,1,39,29,43,72
318,1,39,46,47,93
319,1,39,2,1,3
320,1,39,46,51,97
321,1,39,1,2,3
322,1,39,26,27,53
323,1,39,1,4,5
324,1,39,47,45,92
325,1,39,73,76,149
326,1,39,12,13,25
327,1,39,30,46,76
328,1,39,67,57,124
329,1,39,32,29,61
330,1,39,33,23,56
331,1,39,382,495,877
332,1,39,9,7,16
333,1,39,57,83,140
334,1,39,71,58,129
335,1,39,47,50,97
336,1,39,40,37,77
337,1,39,20,18,38
338,1,39,22,34,56
339,1,39,10,7,17
340,1,39,5,4,9
341,1,39,9,7,16
342,1,39,36,24,60
343,1,39,10,20,30
344,1,39,110,120,230
345,1,39,80,75,155
346,1,39,50,27,77
347,1,39,28,38,66
348,1,39,28,34,62
349,1,39,64,74,138
350,1,39,15,20,35
351,1,39,16,16,32
352,1,39,17,17,34
353,1,39,51,64,115
354,1,39,13,10,23
355,1,39,20,27,47
356,1,39,60,46,106
357,1,39,5,17,22
358,1,39,34,22,56
359,1,39,22,20,42
360,1,39,40,33,73
361,1,39,12,5,17
362,1,39,56,44,100
363,1,39,16,12,28
364,1,39,53,38,91
365,1,39,39,35,74
366,1,39,44,25,69
367,1,39,58,38,96
368,1,39,7,17,24
369,1,39,30,22,52
370,1,39,6,4,10
371,1,39,42,31,73
372,1,39,38,32,70
373,1,39,13,13,26
374,1,39,37,37,74
375,1,39,10,12,22
376,1,39,34,44,78
377,1,39,44,48,92
378,1,39,23,17,40
379,1,39,27,19,46
380,1,39,32,31,63
381,1,39,5,12,17
382,1,39,59,55,114
383,1,39,32,32,64
384,1,39,39,41,80
385,1,39,10,12,22
386,1,39,27,29,56
387,1,39,12,9,21
388,1,39,24,23,47
389,1,39,0,0,0
390,1,39,240,268,508
391,1,39,17,9,26
392,1,39,10,19,29
393,1,39,73,62,135
394,1,39,32,31,63
395,1,39,55,67,122
396,1,39,30,32,62
397,1,39,15,14,29
398,1,39,39,38,77
399,1,39,18,13,31
400,1,39,16,14,30
401,1,39,10,12,22
402,1,39,17,14,31
403,1,39,53,44,97
404,1,39,2,10,12
405,1,39,157,165,322
406,1,39,56,53,109
407,1,39,2,4,6
408,1,39,46,53,99
409,1,39,14,16,30
410,1,39,27,36,63
411,1,39,53,32,85
412,1,39,0,3,3
413,1,39,3,2,5
414,1,39,6,11,17
415,1,39,16,21,37
416,1,39,31,27,58
417,1,39,3,6,9
418,1,39,49,43,92
419,1,39,33,22,55
420,1,39,36,59,95
421,1,39,65,41,106
422,1,39,85,96,181
423,1,39,1,5,6
424,1,39,0,1,1
0,1,42,82,86,168
1,1,42,30,14,44
2,1,42,63,51,114
3,1,42,38,41,79
4,1,42,33,32,65
5,1,42,45,46,91
6,1,42,18,17,35
7,1,42,41,37,78
8,1,42,48,44,92
9,1,42,24,32,56
10,1,42,54,60,114
11,1,42,17,12,29
12,1,42,29,23,52
13,1,42,42,39,81
14,1,42,34,38,72
15,1,42,78,70,148
16,1,42,67,73,140
17,1,42,38,40,78
18,1,42,31,31,62
19,1,42,24,7,31
20,1,42,15,16,31
21,1,42,53,39,92
22,1,42,11,14,25
23,1,42,31,45,76
24,1,42,43,38,81
25,1,42,23,24,47
26,1,42,67,63,130
27,1,42,20,18,38
28,1,42,53,29,82
29,1,42,41,30,71
30,1,42,25,27,52
31,1,42,32,30,62
32,1,42,79,66,145
33,1,42,176,195,371
34,1,42,23,20,43
35,1,42,45,46,91
36,1,42,49,48,97
37,1,42,7,7,14
38,1,42,11,14,25
39,1,42,50,72,122
40,1,42,18,12,30
41,1,42,19,32,51
42,1,42,38,39,77
43,1,42,31,19,50
44,1,42,11,19,30
45,1,42,17,15,32
46,1,42,27,34,61
47,1,42,4,9,13
48,1,42,26,36,62
49,1,42,38,35,73
50,1,42,8,21,29
51,1,42,17,26,43
52,1,42,37,55,92
53,1,42,0,0,0
54,1,42,17,15,32
55,1,42,123,97,220
56,1,42,13,13,26
57,1,42,60,70,130
58,1,42,57,55,112
59,1,42,197,160,357
60,1,42,39,30,69
61,1,42,48,29,77
62,1,42,35,31,66
63,1,42,28,29,57
64,1,42,43,44,87
65,1,42,21,24,45
66,1,42,7,11,18
67,1,42,26,25,51
68,1,42,61,43,104
69,1,42,49,70,119
70,1,42,48,39,87
71,1,42,79,78,157
72,1,42,14,16,30
73,1,42,34,57,91
74,1,42,19,18,37
75,1,42,14,15,29
76,1,42,16,32,48
77,1,42,35,36,71
78,1,42,20,22,42
79,1,42,18,15,33
80,1,42,18,24,42
81,1,42,17,15,32
82,1,42,28,27,55
83,1,42,37,54,91
84,1,42,22,25,47
85,1,42,30,42,72
86,1,42,20,19,39
87,1,42,51,36,87
88,1,42,14,31,45
89,1,42,28,26,54
90,1,42,55,62,117
91,1,42,72,55,127
92,1,42,11,21,32
93,1,42,28,28,56
94,1,42,10,13,23
95,1,42,9,12,21
96,1,42,53,59,112
97,1,42,34,31,65
98,1,42,11,5,16
99,1,42,48,56,104
100,1,42,42,41,83
101,1,42,34,39,73
102,1,42,24,23,47
103,1,42,73,73,146
104,1,42,27,28,55
105,1,42,48,27,75
106,1,42,11,16,27
107,1,42,35,23,58
108,1,42,65,61,126
109,1,42,12,22,34
110,1,42,41,33,74
111,1,42,44,47,91
112,1,42,27,29,56
113,1,42,23,31,54
114,1,42,31,25,56
115,1,42,23,49,72
116,1,42,26,26,52
117,1,42,15,22,37
118,1,42,17,23,40
119,1,42,40,29,69
120,1,42,11,18,29
121,1,42,49,40,89
122,1,42,20,18,38
123,1,42,62,58,120
124,1,42,1,3,4
125,1,42,21,19,40
126,1,42,12,6,18
127,1,42,23,24,47
128,1,42,10,18,28
129,1,42,28,24,52
130,1,42,29,35,64
131,1,42,53,35,88
132,1,42,35,35,70
133,1,42,16,20,36
134,1,42,61,39,100
135,1,42,23,26,49
136,1,42,15,20,35
137,1,42,4,8,12
138,1,42,28,22,50
139,1,42,15,17,32
140,1,42,58,73,131
141,1,42,61,75,136
142,1,42,44,41,85
143,1,42,26,20,46
144,1,42,8,5,13
145,1,42,29,43,72
146,1,42,20,29,49
147,1,42,10,14,24
148,1,42,2,6,8
149,1,42,15,19,34
150,1,42,3,9,12
151,1,42,25,15,40
152,1,42,33,25,58
153,1,42,11,22,33
154,1,42,67,95,162
155,1,42,77,67,144
156,1,42,25,41,66
157,1,42,26,23,49
158,1,42,12,15,27
159,1,42,25,26,51
160,1,42,12,13,25
161,1,42,36,30,66
162,1,42,8,7,15
163,1,42,18,7,25
164,1,42,10,23,33
165,1,42,34,44,78
166,1,42,69,64,133
167,1,42,5,17,22
168,1,42,55,40,95
169,1,42,7,13,20
170,1,42,92,66,158
171,1,42,18,15,33
172,1,42,16,16,32
173,1,42,62,55,117
174,1,42,24,22,46
175,1,42,20,14,34
176,1,42,15,13,28
177,1,42,36,29,65
178,1,42,20,21,41
179,1,42,11,13,24
180,1,42,19,12,31
181,1,42,39,49,88
182,1,42,23,22,45
183,1,42,34,34,68
184,1,42,64,69,133
185,1,42,10,6,16
186,1,42,95,93,188
187,1,42,57,62,119
188,1,42,56,53,109
189,1,42,1,0,1
190,1,42,19,27,46
191,1,42,37,47,84
192,1,42,23,26,49
193,1,42,25,40,65
194,1,42,32,20,52
195,1,42,53,33,86
196,1,42,19,15,34
197,1,42,9,16,25
198,1,42,25,5,30
199,1,42,1,0,1
200,1,42,11,8,19
201,1,42,48,36,84
202,1,42,0,0,0
203,1,42,77,58,135
204,1,42,114,112,226
205,1,42,6,7,13
206,1,42,1,4,5
207,1,42,28,30,58
208,1,42,2,4,6
209,1,42,128,122,250
210,1,42,3,5,8
211,1,42,47,50,97
212,1,42,3,6,9
213,1,42,28,31,59
214,1,42,31,11,42
215,1,42,124,106,230
216,1,42,2,4,6
217,1,42,6,12,18
218,1,42,28,45,73
219,1,42,27,14,41
220,1,42,23,20,43
221,1,42,62,71,133
222,1,42,103,116,219
223,1,42,21,20,41
224,1,42,6,2,8
225,1,42,2,5,7
226,1,42,87,96,183
227,1,42,0,0,0
228,1,42,20,10,30
229,1,42,4,8,12
230,1,42,26,20,46
231,1,42,37,25,62
232,1,42,10,14,24
233,1,42,45,47,92
234,1,42,24,14,38
235,1,42,4,1,5
236,1,42,51,40,91
237,1,42,37,43,80
238,1,42,28,32,60
239,1,42,9,8,17
240,1,42,51,37,88
241,1,42,22,21,43
242,1,42,37,45,82
243,1,42,24,31,55
244,1,42,25,28,53
245,1,42,31,31,62
246,1,42,9,8,17
247,1,42,30,24,54
248,1,42,58,40,98
249,1,42,58,63,121
250,1,42,16,14,30
251,1,42,7,9,16
252,1,42,8,12,20
253,1,42,25,21,46
254,1,42,36,36,72
255,1,42,16,23,39
256,1,42,42,22,64
257,1,42,127,198,325
258,1,42,0,1,1
259,1,42,285,345,630
260,1,42,23,15,38
261,1,42,98,89,187
262,1,42,3,5,8
263,1,42,21,17,38
264,1,42,2,2,4
265,1,42,2,3,5
266,1,42,28,26,54
267,1,42,0,0,0
268,1,42,7,9,16
269,1,42,38,31,69
270,1,42,1,2,3
271,1,42,0,0,0
272,1,42,80,167,247
273,1,42,60,47,107
274,1,42,11,13,24
275,1,42,15,12,27
276,1,42,7,8,15
277,1,42,44,22,66
278,1,42,10,8,18
279,1,42,67,85,152
280,1,42,4,8,12
281,1,42,6,17,23
282,1,42,0,1,1
283,1,42,102,45,147
284,1,42,27,29,56
285,1,42,0,5,5
286,1,42,24,31,55
287,1,42,24,14,38
288,1,42,2,0,2
289,1,42,69,55,124
290,1,42,0,0,0
291,1,42,24,19,43
292,1,42,21,21,42
293,1,42,0,1,1
294,1,42,23,28,51
295,1,42,11,14,25
296,1,42,69,82,151
297,1,42,34,31,65
298,1,42,16,24,40
299,1,42,64,46,110
300,1,42,16,6,22
301,1,42,13,19,32
302,1,42,32,26,58
303,1,42,10,9,19
304,1,42,0,2,2
305,1,42,1,12,13
306,1,42,16,12,28
307,1,42,5,7,12
308,1,42,19,13,32
309,1,42,47,66,113
310,1,42,27,26,53
311,1,42,19,18,37
312,1,42,12,6,18
313,1,42,39,27,66
314,1,42,1,0,1
315,1,42,66,61,127
316,1,42,74,63,137
317,1,42,22,30,52
318,1,42,29,28,57
319,1,42,1,5,6
320,1,42,29,36,65
321,1,42,1,2,3
322,1,42,14,24,38
323,1,42,2,1,3
324,1,42,59,47,106
325,1,42,62,35,97
326,1,42,19,21,40
327,1,42,45,39,84
328,1,42,60,48,108
329,1,42,8,14,22
330,1,42,32,24,56
331,1,42,340,407,747
332,1,42,8,1,9
333,1,42,48,42,90
334,1,42,71,55,126
335,1,42,28,44,72
336,1,42,54,26,80
337,1,42,9,9,18
338,1,42,17,22,39
339,1,42,8,8,16
340,1,42,4,5,9
341,1,42,9,9,18
342,1,42,22,25,47
343,1,42,9,9,18
344,1,42,84,78,162
345,1,42,74,60,134
346,1,42,46,34,80
347,1,42,37,19,56
348,1,42,33,24,57
349,1,42,45,47,92
350,1,42,16,17,33
351,1,42,18,16,34
352,1,42,15,15,30
353,1,42,44,44,88
354,1,42,8,11,19
355,1,42,20,16,36
356,1,42,54,47,101
357,1,42,5,9,14
358,1,42,21,19,40
359,1,42,10,12,22
360,1,42,42,37,79
361,1,42,16,7,23
362,1,42,42,33,75
363,1,42,11,5,16
364,1,42,27,29,56
365,1,42,39,29,68
366,1,42,43,21,64
367,1,42,42,34,76
368,1,42,8,7,15
369,1,42,23,14,37
370,1,42,6,4,10
371,1,42,29,29,58
372,1,42,37,47,84
373,1,42,7,5,12
374,1,42,44,31,75
375,1,42,11,14,25
376,1,42,38,55,93
377,1,42,40,32,72
378,1,42,20,21,41
379,1,42,24,16,40
380,1,42,21,20,41
381,1,42,3,4,7
382,1,42,37,31,68
383,1,42,22,21,43
384,1,42,34,39,73
385,1,42,7,9,16
386,1,42,25,17,42
387,1,42,11,11,22
388,1,42,24,24,48
389,1,42,0,1,1
390,1,42,210,222,432
391,1,42,17,16,33
392,1,42,12,19,31
393,1,42,51,61,112
394,1,42,42,36,78
395,1,42,58,67,125
396,1,42,34,32,66
397,1,42,12,12,24
398,1,42,21,40,61
399,1,42,31,17,48
400,1,42,15,9,24
401,1,42,15,14,29
402,1,42,10,13,23
403,1,42,37,26,63
404,1,42,4,6,10
405,1,42,125,165,290
406,1,42,51,53,104
407,1,42,3,7,10
408,1,42,32,42,74
409,1,42,14,11,25
410,1,42,16,36,52
411,1,42,41,25,66
412,1,42,1,5,6
413,1,42,4,7,11
414,1,42,4,7,11
415,1,42,17,24,41
416,1,42,32,30,62
417,1,42,4,7,11
418,1,42,32,34,66
419,1,42,25,25,50
420,1,42,35,45,80
421,1,42,52,42,94
422,1,42,67,82,149
423,1,42,2,5,7
424,1,42,0,0,0
0,1,45,95,105,200
1,1,45,21,15,36
2,1,45,42,55,97
3,1,45,44,28,72
4,1,45,29,32,61
5,1,45,50,49,99
6,1,45,25,21,46
7,1,45,26,39,65
8,1,45,51,44,95
9,1,45,23,23,46
10,1,45,49,38,87
11,1,45,27,32,59
12,1,45,17,15,32
13,1,45,35,34,69
14,1,45,66,59,125
15,1,45,83,63,146
16,1,45,89,71,160
17,1,45,30,29,59
18,1,45,27,33,60
19,1,45,11,16,27
20,1,45,20,26,46
21,1,45,54,50,104
22,1,45,11,14,25
23,1,45,34,49,83
24,1,45,97,92,189
25,1,45,19,18,37
26,1,45,52,51,103
27,1,45,26,25,51
28,1,45,44,33,77
29,1,45,34,32,66
30,1,45,22,26,48
31,1,45,20,26,46
32,1,45,81,78,159
33,1,45,187,183,370
34,1,45,17,22,39
35,1,45,33,34,67
36,1,45,44,41,85
37,1,45,8,3,11
38,1,45,9,16,25
39,1,45,46,44,90
40,1,45,20,12,32
41,1,45,10,31,41
42,1,45,28,56,84
43,1,45,22,27,49
44,1,45,9,9,18
45,1,45,20,15,35
46,1,45,25,30,55
47,1,45,11,11,22
48,1,45,43,26,69
49,1,45,30,55,85
50,1,45,8,10,18
51,1,45,32,36,68
52,1,45,54,49,103
53,1,45,0,0,0
54,1,45,10,10,20
55,1,45,120,86,206
56,1,45,4,8,12
57,1,45,65,84,149
58,1,45,65,57,122
59,1,45,292,249,541
60,1,45,45,36,81
61,1,45,34,27,61
62,1,45,35,30,65
63,1,45,41,23,64
64,1,45,60,51,111
65,1,45,23,26,49
66,1,45,10,12,22
67,1,45,17,14,31
68,1,45,31,46,77
69,1,45,48,57,105
70,1,45,43,35,78
71,1,45,63,71,134
72,1,45,9,11,20
73,1,45,51,43,94
74,1,45,21,15,36
75,1,45,15,18,33
76,1,45,28,36,64
77,1,45,31,31,62
78,1,45,23,13,36
79,1,45,12,7,19
80,1,45,23,15,38
81,1,45,14,13,27
82,1,45,23,28,51
83,1,45,46,49,95
84,1,45,25,16,41
85,1,45,26,36,62
86,1,45,20,14,34
87,1,45,47,60,107
88,1,45,12,20,32
89,1,45,23,22,45
90,1,45,50,45,95
91,1,45,87,68,155
92,1,45,14,26,40
93,1,45,28,37,65
94,1,45,10,5,15
95,1,45,10,8,18
96,1,45,76,58,134
97,1,45,27,33,60
98,1,45,6,11,17
99,1,45,54,58,112
100,1,45,27,32,59
101,1,45,34,36,70
102,1,45,23,25,48
103,1,45,70,66,136
104,1,45,23,22,45
105,1,45,20,26,46
106,1,45,9,22,31
107,1,45,18,25,43
108,1,45,40,34,74
109,1,45,13,22,35
110,1,45,31,32,63
111,1,45,55,53,108
112,1,45,36,40,76
113,1,45,15,30,45
114,1,45,25,23,48
115,1,45,40,37,77
116,1,45,20,19,39
117,1,45,14,23,37
118,1,45,11,12,23
119,1,45,33,30,63
120,1,45,14,11,25
121,1,45,33,25,58
122,1,45,8,9,17
123,1,45,60,66,126
124,1,45,0,0,0
125,1,45,13,12,25
126,1,45,5,15,20
127,1,45,30,25,55
128,1,45,4,4,8
129,1,45,22,24,46
130,1,45,34,41,75
131,1,45,37,45,82
132,1,45,28,39,67
133,1,45,9,19,28
134,1,45,40,33,73
135,1,45,53,35,88
136,1,45,26,22,48
137,1,45,3,0,3
138,1,45,16,16,32
139,1,45,10,11,21
140,1,45,57,66,123
141,1,45,74,81,155
142,1,45,36,31,67
143,1,45,31,29,60
144,1,45,10,7,17
145,1,45,29,37,66
146,1,45,13,26,39
147,1,45,7,17,24
148,1,45,10,6,16
149,1,45,8,18,26
150,1,45,0,4,4
151,1,45,18,23,41
152,1,45,32,30,62
153,1,45,24,17,41
154,1,45,134,129,263
155,1,45,85,70,155
156,1,45,22,28,50
157,1,45,19,9,28
158,1,45,5,9,14
159,1,45,19,27,46
160,1,45,9,10,19
161,1,45,27,25,52
162,1,45,6,7,13
163,1,45,11,13,24
164,1,45,9,17,26
165,1,45,24,25,49
166,1,45,58,48,106
167,1,45,8,12,20
168,1,45,27,29,56
169,1,45,14,14,28
170,1,45,47,47,94
171,1,45,29,23,52
172,1,45,22,18,40
173,1,45,55,59,114
174,1,45,15,19,34
175,1,45,20,19,39
176,1,45,5,15,20
177,1,45,36,37,73
178,1,45,21,20,41
179,1,45,23,24,47
180,1,45,30,22,52
181,1,45,31,41,72
182,1,45,19,12,31
183,1,45,32,33,65
184,1,45,67,39,106
185,1,45,20,18,38
186,1,45,77,69,146
187,1,45,57,56,113
188,1,45,52,55,107
189,1,45,0,1,1
190,1,45,17,28,45
191,1,45,33,36,69
192,1,45,14,10,24
193,1,45,34,32,66
194,1,45,18,22,40
195,1,45,37,37,74
196,1,45,12,9,21
197,1,45,8,24,32
198,1,45,24,14,38
199,1,45,0,0,0
200,1,45,7,14,21
201,1,45,45,40,85
202,1,45,0,0,0
203,1,45,79,55,134
204,1,45,112,110,222
205,1,45,8,18,26
206,1,45,1,3,4
207,1,45,30,26,56
208,1,45,0,0,0
209,1,45,114,101,215
210,1,45,4,6,10
211,1,45,42,32,74
212,1,45,0,0,0
213,1,45,14,18,32
214,1,45,26,16,42
215,1,45,124,121,245
216,1,45,3,0,3
217,1,45,6,9,15
218,1,45,15,19,34
219,1,45,27,13,40
220,1,45,5,6,11
221,1,45,76,63,139
222,1,45,149,159,308
223,1,45,19,15,34
224,1,45,7,7,14
225,1,45,2,4,6
226,1,45,114,121,235
227,1,45,1,2,3
228,1,45,15,13,28
229,1,45,5,0,5
230,1,45,25,22,47
231,1,45,31,22,53
232,1,45,9,16,25
233,1,45,67,61,128
234,1,45,18,13,31
235,1,45,0,0,0
236,1,45,38,25,63
237,1,45,29,33,62
238,1,45,17,18,35
239,1,45,6,5,11
240,1,45,37,38,75
241,1,45,13,21,34
242,1,45,33,26,59
243,1,45,29,47,76
244,1,45,34,40,74
245,1,45,21,24,45
246,1,45,8,12,20
247,1,45,24,19,43
248,1,45,42,29,71
249,1,45,41,40,81
250,1,45,12,14,26
251,1,45,6,13,19
252,1,45,6,10,16
253,1,45,17,15,32
254,1,45,25,17,42
255,1,45,13,16,29
256,1,45,48,29,77
257,1,45,89,148,237
258,1,45,1,0,1
259,1,45,217,296,513
260,1,45,19,13,32
261,1,45,110,111,221
262,1,45,6,5,11
263,1,45,13,15,28
264,1,45,1,4,5
265,1,45,0,0,0
266,1,45,11,9,20
267,1,45,1,0,1
268,1,45,11,6,17
269,1,45,16,16,32
270,1,45,0,1,1
271,1,45,1,0,1
272,1,45,61,131,192
273,1,45,78,65,143
274,1,45,21,30,51
275,1,45,17,10,27
276,1,45,3,3,6
277,1,45,27,30,57
278,1,45,7,1,8
279,1,45,69,68,137
280,1,45,3,7,10
281,1,45,8,3,11
282,1,45,0,0,0
283,1,45,67,31,98
284,1,45,19,19,38
285,1,45,4,3,7
286,1,45,15,15,30
287,1,45,20,15,35
288,1,45,1,0,1
289,1,45,55,47,102
290,1,45,0,0,0
291,1,45,46,46,92
292,1,45,26,16,42
293,1,45,0,2,2
294,1,45,36,28,64
295,1,45,12,16,28
296,1,45,36,63,99
297,1,45,23,23,46
298,1,45,13,16,29
299,1,45,49,46,95
300,1,45,8,8,16
301,1,45,9,9,18
302,1,45,26,24,50
303,1,45,8,4,12
304,1,45,0,0,0
305,1,45,1,4,5
306,1,45,14,6,20
307,1,45,1,3,4
308,1,45,14,14,28
309,1,45,29,34,63
310,1,45,26,28,54
311,1,45,15,16,31
312,1,45,17,13,30
313,1,45,27,30,57
314,1,45,1,2,3
315,1,45,99,92,191
316,1,45,52,44,96
317,1,45,13,14,27
318,1,45,24,21,45
319,1,45,1,1,2
320,1,45,30,27,57
321,1,45,2,2,4
322,1,45,17,11,28
323,1,45,0,0,0
324,1,45,36,39,75
325,1,45,42,32,74
326,1,45,16,14,30
327,1,45,22,23,45
328,1,45,33,24,57
329,1,45,14,7,21
330,1,45,28,14,42
331,1,45,251,344,595
332,1,45,4,3,7
333,1,45,25,26,51
334,1,45,77,66,143
335,1,45,39,51,90
336,1,45,31,13,44
337,1,45,3,5,8
338,1,45,28,19,47
339,1,45,8,11,19
340,1,45,1,1,2
341,1,45,8,4,12
342,1,45,20,23,43
343,1,45,14,11,25
344,1,45,71,67,138
345,1,45,69,40,109
346,1,45,34,24,58
347,1,45,34,24,58
348,1,45,15,11,26
349,1,45,31,29,60
350,1,45,16,17,33
351,1,45,21,26,47
352,1,45,7,8,15
353,1,45,45,31,76
354,1,45,8,7,15
355,1,45,17,9,26
356,1,45,48,33,81
357,1,45,5,5,10
358,1,45,19,11,30
359,1,45,18,18,36
360,1,45,37,32,69
361,1,45,7,8,15
362,1,45,36,32,68
363,1,45,10,12,22
364,1,45,28,32,60
365,1,45,38,43,81
366,1,45,21,14,35
367,1,45,41,40,81
368,1,45,9,18,27
369,1,45,8,6,14
370,1,45,3,1,4
371,1,45,31,31,62
372,1,45,35,25,60
373,1,45,7,9,16
374,1,45,36,16,52
375,1,45,7,8,15
376,1,45,18,34,52
377,1,45,24,25,49
378,1,45,11,8,19
379,1,45,22,11,33
380,1,45,12,20,32
381,1,45,7,6,13
382,1,45,26,28,54
383,1,45,12,15,27
384,1,45,32,24,56
385,1,45,7,7,14
386,1,45,30,27,57
387,1,45,7,5,12
388,1,45,25,17,42
389,1,45,0,0,0
390,1,45,219,194,413
391,1,45,12,14,26
392,1,45,6,16,22
393,1,45,54,55,109
394,1,45,35,34,69
395,1,45,53,50,103
396,1,45,29,25,54
397,1,45,10,13,23
398,1,45,29,34,63
399,1,45,25,21,46
400,1,45,8,14,22
401,1,45,20,14,34
402,1,45,18,23,41
403,1,45,52,36,88
404,1,45,3,4,7
405,1,45,108,155,263
406,1,45,60,64,124
407,1,45,2,6,8
408,1,45,48,61,109
409,1,45,16,13,29
410,1,45,24,40,64
411,1,45,44,39,83
412,1,45,0,3,3
413,1,45,4,8,12
414,1,45,6,11,17
415,1,45,15,23,38
416,1,45,26,14,40
417,1,45,9,14,23
418,1,45,35,30,65
419,1,45,15,13,28
420,1,45,30,31,61
421,1,45,49,37,86
422,1,45,54,67,121
423,1,45,1,3,4
424,1,45,0,2,2
0,1,48,85,114,199
1,1,48,20,20,40
2,1,48,50,38,88
3,1,48,43,32,75
4,1,48,25,45,70
5,1,48,53,41,94
6,1,48,27,27,54
7,1,48,27,19,46
8,1,48,42,33,75
9,1,48,18,23,41
10,1,48,34,34,68
11,1,48,7,17,24
12,1,48,20,19,39
13,1,48,36,27,63
14,1,48,45,43,88
15,1,48,58,47,105
16,1,48,68,59,127
17,1,48,24,27,51
18,1,48,25,30,55
19,1,48,9,17,26
20,1,48,25,30,55
21,1,48,38,31,69
22,1,48,13,19,32
23,1,48,48,48,96
24,1,48,90,95,185
25,1,48,20,15,35
26,1,48,70,43,113
27,1,48,27,34,61
28,1,48,48,37,85
29,1,48,30,36,66
30,1,48,30,32,62
31,1,48,42,39,81
32,1,48,58,77,135
33,1,48,156,156,312
34,1,48,14,18,32
35,1,48,25,33,58
36,1,48,36,46,82
37,1,48,11,11,22
38,1,48,7,6,13
39,1,48,45,41,86
40,1,48,10,9,19
41,1,48,21,15,36
42,1,48,33,66,99
43,1,48,29,40,69
44,1,48,9,5,14
45,1,48,45,33,78
46,1,48,20,24,44
47,1,48,4,8,12
48,1,48,47,42,89
49,1,48,29,36,65
50,1,48,9,13,22
51,1,48,28,40,68
52,1,48,43,54,97
53,1,48,0,0,0
54,1,48,11,9,20
55,1,48,84,69,153
56,1,48,7,6,13
57,1,48,67,84,151
58,1,48,41,38,79
59,1,48,256,177,433
60,1,48,34,35,69
61,1,48,27,20,47
62,1,48,38,25,63
63,1,48,30,33,63
64,1,48,69,66,135
65,1,48,28,24,52
66,1,48,16,13,29
67,1,48,24,23,47
68,1,48,56,64,120
69,1,48,67,59,126
70,1,48,31,21,52
71,1,48,65,70,135
72,1,48,10,8,18
73,1,48,43,35,78
74,1,48,23,16,39
75,1,48,28,44,72
76,1,48,17,23,40
77,1,48,21,29,50
78,1,48,24,13,37
79,1,48,16,16,32
80,1,48,24,21,45
81,1,48,10,11,21
82,1,48,21,26,47
83,1,48,74,73,147
84,1,48,8,8,16
85,1,48,26,24,50
86,1,48,18,12,30
87,1,48,40,44,84
88,1,48,7,11,18
89,1,48,21,14,35
90,1,48,53,34,87
91,1,48,86,75,161
92,1,48,9,30,39
93,1,48,23,24,47
94,1,48,9,8,17
95,1,48,6,15,21
96,1,48,62,44,106
97,1,48,29,33,62
98,1,48,19,12,31
99,1,48,74,42,116
100,1,48,38,47,85
101,1,48,39,37,76
102,1,48,23,16,39
103,1,48,76,59,135
104,1,48,32,32,64
105,1,48,25,20,45
106,1,48,13,18,31
107,1,48,20,22,42
108,1,48,55,54,109
109,1,48,11,24,35
110,1,48,26,19,45
111,1,48,41,41,82
112,1,48,26,25,51
113,1,48,20,31,51
114,1,48,31,30,61
115,1,48,30,52,82
116,1,48,22,20,42
117,1,48,24,26,50
118,1,48,14,21,35
119,1,48,48,38,86
120,1,48,17,17,34
121,1,48,26,29,55
122,1,48,11,8,19
123,1,48,55,73,128
124,1,48,0,0,0
125,1,48,9,15,24
126,1,48,11,11,22
127,1,48,15,19,34
128,1,48,4,10,14
129,1,48,30,30,60
130,1,48,48,41,89
131,1,48,58,44,102
132,1,48,34,22,56
133,1,48,13,8,21
134,1,48,66,53,119
135,1,48,51,47,98
136,1,48,21,17,38
137,1,48,2,0,2
138,1,48,10,11,21
139,1,48,11,14,25
140,1,48,40,65,105
141,1,48,60,86,146
142,1,48,24,12,36
143,1,48,31,22,53
144,1,48,6,7,13
145,1,48,50,61,111
146,1,48,13,14,27
147,1,48,13,14,27
148,1,48,7,6,13
149,1,48,20,32,52
150,1,48,0,2,2
151,1,48,18,12,30
152,1,48,16,22,38
153,1,48,9,16,25
154,1,48,116,109,225
155,1,48,61,45,106
156,1,48,30,29,59
157,1,48,23,14,37
158,1,48,10,8,18
159,1,48,27,40,67
160,1,48,17,10,27
161,1,48,31,26,57
162,1,48,6,10,16
163,1,48,7,8,15
164,1,48,16,6,22
165,1,48,29,29,58
166,1,48,43,53,96
167,1,48,2,12,14
168,1,48,10,17,27
169,1,48,23,37,60
170,1,48,77,84,161
171,1,48,15,15,30
172,1,48,12,13,25
173,1,48,68,61,129
174,1,48,10,11,21
175,1,48,21,14,35
176,1,48,17,14,31
177,1,48,44,31,75
178,1,48,18,27,45
179,1,48,19,15,34
180,1,48,21,10,31
181,1,48,28,30,58
182,1,48,20,14,34
183,1,48,34,36,70
184,1,48,47,33,80
185,1,48,16,13,29
186,1,48,68,51,119
187,1,48,48,37,85
188,1,48,62,80,142
189,1,48,0,3,3
190,1,48,31,29,60
191,1,48,13,29,42
192,1,48,8,11,19
193,1,48,17,19,36
194,1,48,15,16,31
195,1,48,23,37,60
196,1,48,15,20,35
197,1,48,12,18,30
198,1,48,10,13,23
199,1,48,0,1,1
200,1,48,7,8,15
201,1,48,40,30,70
202,1,48,0,0,0
203,1,48,64,55,119
204,1,48,146,105,251
205,1,48,10,20,30
206,1,48,1,2,3
207,1,48,37,19,56
208,1,48,0,2,2
209,1,48,88,92,180
210,1,48,4,5,9
211,1,48,40,36,76
212,1,48,0,0,0
213,1,48,17,15,32
214,1,48,46,13,59
215,1,48,113,93,206
216,1,48,1,2,3
217,1,48,10,5,15
218,1,48,24,27,51
219,1,48,14,11,25
220,1,48,16,27,43
221,1,48,84,73,157
222,1,48,106,105,211
223,1,48,9,13,22
224,1,48,2,4,6
225,1,48,6,3,9
226,1,48,107,88,195
227,1,48,0,2,2
228,1,48,15,8,23
229,1,48,2,7,9
230,1,48,38,41,79
231,1,48,28,15,43
232,1,48,11,23,34
233,1,48,62,63,125
234,1,48,14,14,28
235,1,48,1,1,2
236,1,48,25,16,41
237,1,48,23,43,66
238,1,48,15,25,40
239,1,48,4,9,13
240,1,48,36,26,62
241,1,48,15,18,33
242,1,48,32,21,53
243,1,48,30,37,67
244,1,48,46,53,99
245,1,48,24,9,33
246,1,48,8,12,20
247,1,48,27,19,46
248,1,48,37,36,73
249,1,48,51,27,78
250,1,48,14,13,27
251,1,48,10,9,19
252,1,48,8,10,18
253,1,48,15,15,30
254,1,48,23,19,42
255,1,48,13,8,21
256,1,48,28,22,50
257,1,48,91,166,257
258,1,48,0,0,0
259,1,48,230,277,507
260,1,48,24,8,32
261,1,48,15,14,29
262,1,48,3,12,15
263,1,48,20,13,33
264,1,48,0,0,0
265,1,48,2,1,3
266,1,48,12,11,23
267,1,48,1,2,3
268,1,48,8,10,18
269,1,48,21,25,46
270,1,48,1,0,1
271,1,48,1,1,2
272,1,48,54,121,175
273,1,48,55,51,106
274,1,48,17,22,39
275,1,48,7,8,15
276,1,48,6,5,11
277,1,48,37,28,65
278,1,48,6,6,12
279,1,48,76,75,151
280,1,48,5,3,8
281,1,48,12,7,19
282,1,48,0,2,2
283,1,48,99,38,137
284,1,48,28,39,67
285,1,48,1,1,2
286,1,48,13,9,22
287,1,48,14,11,25
288,1,48,0,2,2
289,1,48,38,55,93
290,1,48,0,0,0
291,1,48,29,25,54
292,1,48,14,13,27
293,1,48,0,1,1
294,1,48,24,22,46
295,1,48,12,12,24
296,1,48,42,72,114
297,1,48,28,39,67
298,1,48,12,13,25
299,1,48,56,42,98
300,1,48,7,12,19
301,1,48,15,7,22
302,1,48,23,15,38
303,1,48,9,7,16
304,1,48,0,1,1
305,1,48,5,7,12
306,1,48,12,10,22
307,1,48,2,2,4
308,1,48,13,15,28
309,1,48,45,43,88
310,1,48,17,14,31
311,1,48,17,22,39
312,1,48,4,5,9
313,1,48,22,23,45
314,1,48,0,0,0
315,1,48,54,57,111
316,1,48,35,24,59
317,1,48,11,15,26
318,1,48,19,16,35
319,1,48,0,1,1
320,1,48,26,24,50
321,1,48,2,5,7
322,1,48,9,12,21
323,1,48,0,1,1
324,1,48,31,31,62
325,1,48,52,23,75
326,1,48,8,9,17
327,1,48,21,12,33
328,1,48,26,16,42
329,1,48,5,19,24
330,1,48,17,21,38
331,1,48,287,368,655
332,1,48,6,7,13
333,1,48,11,18,29
334,1,48,74,45,119
335,1,48,59,56,115
336,1,48,25,23,48
337,1,48,4,7,11
338,1,48,20,16,36
339,1,48,11,10,21
340,1,48,5,1,6
341,1,48,7,5,12
342,1,48,25,15,40
343,1,48,16,11,27
344,1,48,57,33,90
345,1,48,39,43,82
346,1,48,23,20,43
347,1,48,28,23,51
348,1,48,15,17,32
349,1,48,17,18,35
350,1,48,10,9,19
351,1,48,16,18,34
352,1,48,16,7,23
353,1,48,43,31,74
354,1,48,4,7,11
355,1,48,14,9,23
356,1,48,33,35,68
357,1,48,3,2,5
358,1,48,20,12,32
359,1,48,22,18,40
360,1,48,29,36,65
361,1,48,12,6,18
362,1,48,31,43,74
363,1,48,7,8,15
364,1,48,29,21,50
365,1,48,31,47,78
366,1,48,19,17,36
367,1,48,32,35,67
368,1,48,4,9,13
369,1,48,8,21,29
370,1,48,0,3,3
371,1,48,23,18,41
372,1,48,25,25,50
373,1,48,5,9,14
374,1,48,25,16,41
375,1,48,2,7,9
376,1,48,28,36,64
377,1,48,43,41,84
378,1,48,16,18,34
379,1,48,15,16,31
380,1,48,15,15,30
381,1,48,3,8,11
382,1,48,23,20,43
383,1,48,18,14,32
384,1,48,24,35,59
385,1,48,3,5,8
386,1,48,32,30,62
387,1,48,6,4,10
388,1,48,16,8,24
389,1,48,0,0,0
390,1,48,195,219,414
391,1,48,9,7,16
392,1,48,9,16,25
393,1,48,43,55,98
394,1,48,43,44,87
395,1,48,46,39,85
396,1,48,18,15,33
397,1,48,7,10,17
398,1,48,15,36,51
399,1,48,21,15,36
400,1,48,7,7,14
401,1,48,8,4,12
402,1,48,19,14,33
403,1,48,41,37,78
404,1,48,2,3,5
405,1,48,143,151,294
406,1,48,70,70,140
407,1,48,2,6,8
408,1,48,78,86,164
409,1,48,12,11,23
410,1,48,37,55,92
411,1,48,47,48,95
412,1,48,0,2,2
413,1,48,4,4,8
414,1,48,4,8,12
415,1,48,25,29,54
416,1,48,22,18,40
417,1,48,5,8,13
418,1,48,20,27,47
419,1,48,28,23,51
420,1,48,31,42,73
421,1,48,58,39,97
422,1,48,38,41,79
423,1,48,0,6,6
424,1,48,0,0,0
0,1,51,65,168,233
1,1,51,22,16,38
2,1,51,66,44,110
3,1,51,35,35,70
4,1,51,35,23,58
5,1,51,51,78,129
6,1,51,20,19,39
7,1,51,27,31,58
8,1,51,47,33,80
9,1,51,23,28,51
10,1,51,44,47,91
11,1,51,18,12,30
12,1,51,16,16,32
13,1,51,44,41,85
14,1,51,22,26,48
15,1,51,58,31,89
16,1,51,70,59,129
17,1,51,33,33,66
18,1,51,28,33,61
19,1,51,13,20,33
20,1,51,22,15,37
21,1,51,31,37,68
22,1,51,12,15,27
23,1,51,51,46,97
24,1,51,67,60,127
25,1,51,22,34,56
26,1,51,45,36,81
27,1,51,20,32,52
28,1,51,47,50,97
29,1,51,61,65,126
30,1,51,33,35,68
31,1,51,29,30,59
32,1,51,89,82,171
33,1,51,175,158,333
34,1,51,12,18,30
35,1,51,30,39,69
36,1,51,42,41,83
37,1,51,8,17,25
38,1,51,9,5,14
39,1,51,62,37,99
40,1,51,21,34,55
41,1,51,17,26,43
42,1,51,32,77,109
43,1,51,22,33,55
44,1,51,10,24,34
45,1,51,37,26,63
46,1,51,28,27,55
47,1,51,8,4,12
48,1,51,67,34,101
49,1,51,29,42,71
50,1,51,9,17,26
51,1,51,28,44,72
52,1,51,40,62,102
53,1,51,0,0,0
54,1,51,13,7,20
55,1,51,121,65,186
56,1,51,5,9,14
57,1,51,52,36,88
58,1,51,47,48,95
59,1,51,179,117,296
60,1,51,32,19,51
61,1,51,41,39,80
62,1,51,41,21,62
63,1,51,40,30,70
64,1,51,51,46,97
65,1,51,20,35,55
66,1,51,11,9,20
67,1,51,26,23,49
68,1,51,57,45,102
69,1,51,101,77,178
70,1,51,38,21,59
71,1,51,60,61,121
72,1,51,4,3,7
73,1,51,40,42,82
74,1,51,20,11,31
75,1,51,28,30,58
76,1,51,15,14,29
77,1,51,35,38,73
78,1,51,23,19,42
79,1,51,10,11,21
80,1,51,31,30,61
81,1,51,10,19,29
82,1,51,29,15,44
83,1,51,40,50,90
84,1,51,14,14,28
85,1,51,31,23,54
86,1,51,15,13,28
87,1,51,61,72,133
88,1,51,19,25,44
89,1,51,14,19,33
90,1,51,38,32,70
91,1,51,120,73,193
92,1,51,6,18,24
93,1,51,30,37,67
94,1,51,8,8,16
95,1,51,11,12,23
96,1,51,47,51,98
97,1,51,31,52,83
98,1,51,12,15,27
99,1,51,78,67,145
100,1,51,52,43,95
101,1,51,69,88,157
102,1,51,31,26,57
103,1,51,60,50,110
104,1,51,24,31,55
105,1,51,26,21,47
106,1,51,10,15,25
107,1,51,20,22,42
108,1,51,64,55,119
109,1,51,20,26,46
110,1,51,38,24,62
111,1,51,73,78,151
112,1,51,27,30,57
113,1,51,28,33,61
114,1,51,39,56,95
115,1,51,38,65,103
116,1,51,23,20,43
117,1,51,21,26,47
118,1,51,23,23,46
119,1,51,52,61,113
120,1,51,21,21,42
121,1,51,29,28,57
122,1,51,10,18,28
123,1,51,54,79,133
124,1,51,1,3,4
125,1,51,16,16,32
126,1,51,15,14,29
127,1,51,29,24,53
128,1,51,6,10,16
129,1,51,28,37,65
130,1,51,35,42,77
131,1,51,56,47,103
132,1,51,26,24,50
133,1,51,19,27,46
134,1,51,58,44,102
135,1,51,53,62,115
136,1,51,24,28,52
137,1,51,4,1,5
138,1,51,23,24,47
139,1,51,10,7,17
140,1,51,65,86,151
141,1,51,73,99,172
142,1,51,18,20,38
143,1,51,30,29,59
144,1,51,8,6,14
145,1,51,45,52,97
146,1,51,11,18,29
147,1,51,28,21,49
148,1,51,4,8,12
149,1,51,18,25,43
150,1,51,3,3,6
151,1,51,18,12,30
152,1,51,25,34,59
153,1,51,11,17,28
154,1,51,96,117,213
155,1,51,64,47,111
156,1,51,20,25,45
157,1,51,27,11,38
158,1,51,8,12,20
159,1,51,28,39,67
160,1,51,15,21,36
161,1,51,33,27,60
162,1,51,5,6,11
163,1,51,11,21,32
164,1,51,13,18,31
165,1,51,44,30,74
166,1,51,65,70,135
167,1,51,5,7,12
168,1,51,21,14,35
169,1,51,18,18,36
170,1,51,79,62,141
171,1,51,15,29,44
172,1,51,16,11,27
173,1,51,95,95,190
174,1,51,14,35,49
175,1,51,30,11,41
176,1,51,17,20,37
177,1,51,41,25,66
178,1,51,28,27,55
179,1,51,24,24,48
180,1,51,31,14,45
181,1,51,41,48,89
182,1,51,22,19,41
183,1,51,51,38,89
184,1,51,56,41,97
185,1,51,20,16,36
186,1,51,59,52,111
187,1,51,58,68,126
188,1,51,58,98,156
189,1,51,1,0,1
190,1,51,18,28,46
191,1,51,45,24,69
192,1,51,12,11,23
193,1,51,19,46,65
194,1,51,18,14,32
195,1,51,35,52,87
196,1,51,14,11,25
197,1,51,12,18,30
198,1,51,20,19,39
199,1,51,0,0,0
200,1,51,13,16,29
201,1,51,69,57,126
202,1,51,0,0,0
203,1,51,87,58,145
204,1,51,132,103,235
205,1,51,9,16,25
206,1,51,4,4,8
207,1,51,40,23,63
208,1,51,0,0,0
209,1,51,93,96,189
210,1,51,3,5,8
211,1,51,50,40,90
212,1,51,0,1,1
213,1,51,38,22,60
214,1,51,38,14,52
215,1,51,118,120,238
216,1,51,0,1,1
217,1,51,7,7,14
218,1,51,37,35,72
219,1,51,27,24,51
220,1,51,23,23,46
221,1,51,88,88,176
222,1,51,119,136,255
223,1,51,21,16,37
224,1,51,12,9,21
225,1,51,3,2,5
226,1,51,95,79,174
227,1,51,0,0,0
228,1,51,10,17,27
229,1,51,4,9,13
230,1,51,27,19,46
231,1,51,33,27,60
232,1,51,21,19,40
233,1,51,56,58,114
234,1,51,26,33,59
235,1,51,4,4,8
236,1,51,34,20,54
237,1,51,37,66,103
238,1,51,32,28,60
239,1,51,8,8,16
240,1,51,44,60,104
241,1,51,12,24,36
242,1,51,35,29,64
243,1,51,27,48,75
244,1,51,51,40,91
245,1,51,23,22,45
246,1,51,11,19,30
247,1,51,26,27,53
248,1,51,55,44,99
249,1,51,49,32,81
250,1,51,15,15,30
251,1,51,9,15,24
252,1,51,9,16,25
253,1,51,37,17,54
254,1,51,25,24,49
255,1,51,18,17,35
256,1,51,36,28,64
257,1,51,93,177,270
258,1,51,0,0,0
259,1,51,379,280,659
260,1,51,20,8,28
261,1,51,3,9,12
262,1,51,9,12,21
263,1,51,24,32,56
264,1,51,0,2,2
265,1,51,3,5,8
266,1,51,18,7,25
267,1,51,0,0,0
268,1,51,9,8,17
269,1,51,42,52,94
270,1,51,0,0,0
271,1,51,1,1,2
272,1,51,36,96,132
273,1,51,48,39,87
274,1,51,14,16,30
275,1,51,10,12,22
276,1,51,3,10,13
277,1,51,40,42,82
278,1,51,17,13,30
279,1,51,98,99,197
280,1,51,5,8,13
281,1,51,7,9,16
282,1,51,0,2,2
283,1,51,91,43,134
284,1,51,26,27,53
285,1,51,0,1,1
286,1,51,17,18,35
287,1,51,24,41,65
288,1,51,0,1,1
289,1,51,65,76,141
290,1,51,0,0,0
291,1,51,18,18,36
292,1,51,9,5,14
293,1,51,0,0,0
294,1,51,41,42,83
295,1,51,11,12,23
296,1,51,54,57,111
297,1,51,40,56,96
298,1,51,15,12,27
299,1,51,63,58,121
300,1,51,9,13,22
301,1,51,17,7,24
302,1,51,24,30,54
303,1,51,9,5,14
304,1,51,1,0,1
305,1,51,0,15,15
306,1,51,21,13,34
307,1,51,0,5,5
308,1,51,14,18,32
309,1,51,53,47,100
310,1,51,32,34,66
311,1,51,14,16,30
312,1,51,9,7,16
313,1,51,26,18,44
314,1,51,0,1,1
315,1,51,51,66,117
316,1,51,24,30,54
317,1,51,15,13,28
318,1,51,25,17,42
319,1,51,1,3,4
320,1,51,28,19,47
321,1,51,2,5,7
322,1,51,10,5,15
323,1,51,0,1,1
324,1,51,37,51,88
325,1,51,43,24,67
326,1,51,15,17,32
327,1,51,17,14,31
328,1,51,25,26,51
329,1,51,5,12,17
330,1,51,30,18,48
331,1,51,393,354,747
332,1,51,4,3,7
333,1,51,13,5,18
334,1,51,72,38,110
335,1,51,45,54,99
336,1,51,33,24,57
337,1,51,6,9,15
338,1,51,20,26,46
339,1,51,9,21,30
340,1,51,3,8,11
341,1,51,12,9,21
342,1,51,28,30,58
343,1,51,27,18,45
344,1,51,51,51,102
345,1,51,47,52,99
346,1,51,28,28,56
347,1,51,46,24,70
348,1,51,33,23,56
349,1,51,30,19,49
350,1,51,9,15,24
351,1,51,33,27,60
352,1,51,11,20,31
353,1,51,19,19,38
354,1,51,9,10,19
355,1,51,17,25,42
356,1,51,54,41,95
357,1,51,6,6,12
358,1,51,39,22,61
359,1,51,14,15,29
360,1,51,27,31,58
361,1,51,11,5,16
362,1,51,41,39,80
363,1,51,10,8,18
364,1,51,33,36,69
365,1,51,35,51,86
366,1,51,23,13,36
367,1,51,44,49,93
368,1,51,8,9,17
369,1,51,19,18,37
370,1,51,1,2,3
371,1,51,35,18,53
372,1,51,27,18,45
373,1,51,14,10,24
374,1,51,20,21,41
375,1,51,10,9,19
376,1,51,39,39,78
377,1,51,48,55,103
378,1,51,27,19,46
379,1,51,30,22,52
380,1,51,13,18,31
381,1,51,4,7,11
382,1,51,29,28,57
383,1,51,16,14,30
384,1,51,27,33,60
385,1,51,5,6,11
386,1,51,17,19,36
387,1,51,10,5,15
388,1,51,13,10,23
389,1,51,0,0,0
390,1,51,219,261,480
391,1,51,10,13,23
392,1,51,11,22,33
393,1,51,67,75,142
394,1,51,32,24,56
395,1,51,58,48,106
396,1,51,38,22,60
397,1,51,9,16,25
398,1,51,30,54,84
399,1,51,16,7,23
400,1,51,14,9,23
401,1,51,17,14,31
402,1,51,14,17,31
403,1,51,44,27,71
404,1,51,4,2,6
405,1,51,112,120,232
406,1,51,47,56,103
407,1,51,3,9,12
408,1,51,50,60,110
409,1,51,12,18,30
410,1,51,33,63,96
411,1,51,72,63,135
412,1,51,0,2,2
413,1,51,3,6,9
414,1,51,8,15,23
415,1,51,27,32,59
416,1,51,23,30,53
417,1,51,0,7,7
418,1,51,41,31,72
419,1,51,28,26,54
420,1,51,28,65,93
421,1,51,54,35,89
422,1,51,37,31,68
423,1,51,1,2,3
424,1,51,1,1,2
0,1,54,97,201,298
1,1,54,31,29,60
2,1,54,73,51,124
3,1,54,51,46,97
4,1,54,30,34,64
5,1,54,74,84,158
6,1,54,22,28,50
7,1,54,18,51,69
8,1,54,47,22,69
9,1,54,25,37,62
10,1,54,63,60,123
11,1,54,14,18,32
12,1,54,19,24,43
13,1,54,57,56,113
14,1,54,29,18,47
15,1,54,50,38,88
16,1,54,87,76,163
17,1,54,42,46,88
18,1,54,33,36,69
19,1,54,23,33,56
20,1,54,15,19,34
21,1,54,45,38,83
22,1,54,15,14,29
23,1,54,45,40,85
24,1,54,42,61,103
25,1,54,36,30,66
26,1,54,47,50,97
27,1,54,19,40,59
28,1,54,81,31,112
29,1,54,59,45,104
30,1,54,28,33,61
31,1,54,38,31,69
32,1,54,100,84,184
33,1,54,138,132,270
34,1,54,22,21,43
35,1,54,49,57,106
36,1,54,47,52,99
37,1,54,6,20,26
38,1,54,6,5,11
39,1,54,52,30,82
40,1,54,13,32,45
41,1,54,35,24,59
42,1,54,58,93,151
43,1,54,30,50,80
44,1,54,7,23,30
45,1,54,29,20,49
46,1,54,33,33,66
47,1,54,7,7,14
48,1,54,45,36,81
49,1,54,43,57,100
50,1,54,5,17,22
51,1,54,40,57,97
52,1,54,55,82,137
53,1,54,0,0,0
54,1,54,10,8,18
55,1,54,103,76,179
56,1,54,10,14,24
57,1,54,62,35,97
58,1,54,60,33,93
59,1,54,149,69,218
60,1,54,32,23,55
61,1,54,41,32,73
62,1,54,43,40,83
63,1,54,52,56,108
64,1,54,48,57,105
65,1,54,33,36,69
66,1,54,13,14,27
67,1,54,33,26,59
68,1,54,57,64,121
69,1,54,83,54,137
70,1,54,48,34,82
71,1,54,64,76,140
72,1,54,6,11,17
73,1,54,54,32,86
74,1,54,21,22,43
75,1,54,14,24,38
76,1,54,23,14,37
77,1,54,29,35,64
78,1,54,20,17,37
79,1,54,15,14,29
80,1,54,29,32,61
81,1,54,15,33,48
82,1,54,29,24,53
83,1,54,49,54,103
84,1,54,28,24,52
85,1,54,43,25,68
86,1,54,18,10,28
87,1,54,61,73,134
88,1,54,8,13,21
89,1,54,20,10,30
90,1,54,55,35,90
91,1,54,78,76,154
92,1,54,10,25,35
93,1,54,34,45,79
94,1,54,11,15,26
95,1,54,4,5,9
96,1,54,42,55,97
97,1,54,36,45,81
98,1,54,13,13,26
99,1,54,54,73,127
100,1,54,67,72,139
101,1,54,60,87,147
102,1,54,32,15,47
103,1,54,79,56,135
104,1,54,25,35,60
105,1,54,31,15,46
106,1,54,13,25,38
107,1,54,43,68,111
108,1,54,42,53,95
109,1,54,23,31,54
110,1,54,28,30,58
111,1,54,54,76,130
112,1,54,20,17,37
113,1,54,26,22,48
114,1,54,32,52,84
115,1,54,29,36,65
116,1,54,42,29,71
117,1,54,19,23,42
118,1,54,25,34,59
119,1,54,56,79,135
120,1,54,29,24,53
121,1,54,35,30,65
122,1,54,16,10,26
123,1,54,74,119,193
124,1,54,1,4,5
125,1,54,26,27,53
126,1,54,20,15,35
127,1,54,25,19,44
128,1,54,5,10,15
129,1,54,37,55,92
130,1,54,30,28,58
131,1,54,69,55,124
132,1,54,23,34,57
133,1,54,23,25,48
134,1,54,51,42,93
135,1,54,46,52,98
136,1,54,15,17,32
137,1,54,10,6,16
138,1,54,25,28,53
139,1,54,8,12,20
140,1,54,75,118,193
141,1,54,109,107,216
142,1,54,32,18,50
143,1,54,24,24,48
144,1,54,11,5,16
145,1,54,28,39,67
146,1,54,14,17,31
147,1,54,6,10,16
148,1,54,3,3,6
149,1,54,12,25,37
150,1,54,1,14,15
151,1,54,28,23,51
152,1,54,24,30,54
153,1,54,5,17,22
154,1,54,80,98,178
155,1,54,71,40,111
156,1,54,31,17,48
157,1,54,32,21,53
158,1,54,17,7,24
159,1,54,36,40,76
160,1,54,19,20,39
161,1,54,49,35,84
162,1,54,3,4,7
163,1,54,11,15,26
164,1,54,21,16,37
165,1,54,31,19,50
166,1,54,78,79,157
167,1,54,11,15,26
168,1,54,10,13,23
169,1,54,11,24,35
170,1,54,72,81,153
171,1,54,22,26,48
172,1,54,8,11,19
173,1,54,86,80,166
174,1,54,23,53,76
175,1,54,24,22,46
176,1,54,16,13,29
177,1,54,44,40,84
178,1,54,25,17,42
179,1,54,11,15,26
180,1,54,20,6,26
181,1,54,50,45,95
182,1,54,20,17,37
183,1,54,59,58,117
184,1,54,105,48,153
185,1,54,12,15,27
186,1,54,75,74,149
187,1,54,77,132,209
188,1,54,77,76,153
189,1,54,0,0,0
190,1,54,18,30,48
191,1,54,44,23,67
192,1,54,14,11,25
193,1,54,30,32,62
194,1,54,17,26,43
195,1,54,53,73,126
196,1,54,22,16,38
197,1,54,8,14,22
198,1,54,40,27,67
199,1,54,0,1,1
200,1,54,9,18,27
201,1,54,60,60,120
202,1,54,0,0,0
203,1,54,71,63,134
204,1,54,111,89,200
205,1,54,5,14,19
206,1,54,2,3,5
207,1,54,43,46,89
208,1,54,1,1,2
209,1,54,95,131,226
210,1,54,5,1,6
211,1,54,80,45,125
212,1,54,0,0,0
213,1,54,32,33,65
214,1,54,33,7,40
215,1,54,139,97,236
216,1,54,1,0,1
217,1,54,33,24,57
218,1,54,45,48,93
219,1,54,28,26,54
220,1,54,36,32,68
221,1,54,90,109,199
222,1,54,117,127,244
223,1,54,32,27,59
224,1,54,13,10,23
225,1,54,5,4,9
226,1,54,65,58,123
227,1,54,0,1,1
228,1,54,17,16,33
229,1,54,5,9,14
230,1,54,23,22,45
231,1,54,46,35,81
232,1,54,16,18,34
233,1,54,46,58,104
234,1,54,33,48,81
235,1,54,0,1,1
236,1,54,35,31,66
237,1,54,56,113,169
238,1,54,23,37,60
239,1,54,20,13,33
240,1,54,62,63,125
241,1,54,27,28,55
242,1,54,19,31,50
243,1,54,31,46,77
244,1,54,46,24,70
245,1,54,43,32,75
246,1,54,13,30,43
247,1,54,26,30,56
248,1,54,67,35,102
249,1,54,53,21,74
250,1,54,23,19,42
251,1,54,7,16,23
252,1,54,12,16,28
253,1,54,39,48,87
254,1,54,38,23,61
255,1,54,17,13,30
256,1,54,41,19,60
257,1,54,157,176,333
258,1,54,0,2,2
259,1,54,292,206,498
260,1,54,29,11,40
261,1,54,7,5,12
262,1,54,7,15,22
263,1,54,20,31,51
264,1,54,0,5,5
265,1,54,0,7,7
266,1,54,14,12,26
267,1,54,0,1,1
268,1,54,7,7,14
269,1,54,60,75,135
270,1,54,0,0,0
271,1,54,1,4,5
272,1,54,51,68,119
273,1,54,87,54,141
274,1,54,22,27,49
275,1,54,18,17,35
276,1,54,8,10,18
277,1,54,51,48,99
278,1,54,18,3,21
279,1,54,95,49,144
280,1,54,0,2,2
281,1,54,21,22,43
282,1,54,0,0,0
283,1,54,95,47,142
284,1,54,26,41,67
285,1,54,2,1,3
286,1,54,17,22,39
287,1,54,39,63,102
288,1,54,1,4,5
289,1,54,78,112,190
290,1,54,0,0,0
291,1,54,24,26,50
292,1,54,7,7,14
293,1,54,0,0,0
294,1,54,43,43,86
295,1,54,19,16,35
296,1,54,79,79,158
297,1,54,62,77,139
298,1,54,36,38,74
299,1,54,96,85,181
300,1,54,13,6,19
301,1,54,14,7,21
302,1,54,22,23,45
303,1,54,8,8,16
304,1,54,0,1,1
305,1,54,13,34,47
306,1,54,17,13,30
307,1,54,0,4,4
308,1,54,30,25,55
309,1,54,73,66,139
310,1,54,44,43,87
311,1,54,18,25,43
312,1,54,15,18,33
313,1,54,23,16,39
314,1,54,0,1,1
315,1,54,87,80,167
316,1,54,35,23,58
317,1,54,11,15,26
318,1,54,22,13,35
319,1,54,1,1,2
320,1,54,25,34,59
321,1,54,2,3,5
322,1,54,22,16,38
323,1,54,1,0,1
324,1,54,38,56,94
325,1,54,56,25,81
326,1,54,19,12,31
327,1,54,15,18,33
328,1,54,24,27,51
329,1,54,15,15,30
330,1,54,45,28,73
331,1,54,316,240,556
332,1,54,11,3,14
333,1,54,9,15,24
334,1,54,57,27,84
335,1,54,42,58,100
336,1,54,53,40,93
337,1,54,14,11,25
338,1,54,14,21,35
339,1,54,12,10,22
340,1,54,11,14,25
341,1,54,9,15,24
342,1,54,27,28,55
343,1,54,25,11,36
344,1,54,84,62,146
345,1,54,79,76,155
346,1,54,50,24,74
347,1,54,36,33,69
348,1,54,31,19,50
349,1,54,49,48,97
350,1,54,9,15,24
351,1,54,21,26,47
352,1,54,15,14,29
353,1,54,31,29,60
354,1,54,9,7,16
355,1,54,24,14,38
356,1,54,55,58,113
357,1,54,4,8,12
358,1,54,23,21,44
359,1,54,15,18,33
360,1,54,27,32,59
361,1,54,6,6,12
362,1,54,56,53,109
363,1,54,7,5,12
364,1,54,56,51,107
365,1,54,43,72,115
366,1,54,27,18,45
367,1,54,49,52,101
368,1,54,10,9,19
369,1,54,23,18,41
370,1,54,2,8,10
371,1,54,28,32,60
372,1,54,17,20,37
373,1,54,8,10,18
374,1,54,29,27,56
375,1,54,21,15,36
376,1,54,64,55,119
377,1,54,66,109,175
378,1,54,29,27,56
379,1,54,30,20,50
380,1,54,35,24,59
381,1,54,3,11,14
382,1,54,35,35,70
383,1,54,19,14,33
384,1,54,49,41,90
385,1,54,5,11,16
386,1,54,23,22,45
387,1,54,11,14,25
388,1,54,12,21,33
389,1,54,0,0,0
390,1,54,210,218,428
391,1,54,6,10,16
392,1,54,11,18,29
393,1,54,79,96,175
394,1,54,24,22,46
395,1,54,68,55,123
396,1,54,32,29,61
397,1,54,8,6,14
398,1,54,29,55,84
399,1,54,18,10,28
400,1,54,6,9,15
401,1,54,18,4,22
402,1,54,7,9,16
403,1,54,35,23,58
404,1,54,3,3,6
405,1,54,130,136,266
406,1,54,48,44,92
407,1,54,3,9,12
408,1,54,52,63,115
409,1,54,10,20,30
410,1,54,34,49,83
411,1,54,61,56,117
412,1,54,2,2,4
413,1,54,1,6,7
414,1,54,10,15,25
415,1,54,15,24,39
416,1,54,34,38,72
417,1,54,2,4,6
418,1,54,52,41,93
419,1,54,31,36,67
420,1,54,49,84,133
421,1,54,65,43,108
422,1,54,18,40,58
423,1,54,1,1,2
424,1,54,1,1,2
0,1,57,114,171,285
1,1,57,31,21,52
2,1,57,51,36,87
3,1,57,59,48,107
4,1,57,44,40,84
5,1,57,84,105,189
6,1,57,27,23,50
7,1,57,37,29,66
8,1,57,55,39,94
9,1,57,34,36,70
10,1,57,61,67,128
11,1,57,22,13,35
12,1,57,24,23,47
13,1,57,64,60,124
14,1,57,20,24,44
15,1,57,57,47,104
16,1,57,59,67,126
17,1,57,35,33,68
18,1,57,49,57,106
19,1,57,32,35,67
20,1,57,18,20,38
21,1,57,67,31,98
22,1,57,13,17,30
23,1,57,40,51,91
24,1,57,57,62,119
25,1,57,34,25,59
26,1,57,76,50,126
27,1,57,30,35,65
28,1,57,91,58,149
29,1,57,61,70,131
30,1,57,31,42,73
31,1,57,41,42,83
32,1,57,95,84,179
33,1,57,125,119,244
34,1,57,35,20,55
35,1,57,51,60,111
36,1,57,51,59,110
37,1,57,10,17,27
38,1,57,9,10,19
39,1,57,26,39,65
40,1,57,22,13,35
41,1,57,29,34,63
42,1,57,62,109,171
43,1,57,31,34,65
44,1,57,15,11,26
45,1,57,35,18,53
46,1,57,37,42,79
47,1,57,9,10,19
48,1,57,41,52,93
49,1,57,54,62,116
50,1,57,7,19,26
51,1,57,38,62,100
52,1,57,66,81,147
53,1,57,0,0,0
54,1,57,8,10,18
55,1,57,79,60,139
56,1,57,4,13,17
57,1,57,55,42,97
58,1,57,37,37,74
59,1,57,124,52,176
60,1,57,41,32,73
61,1,57,53,26,79
62,1,57,39,38,77
63,1,57,54,57,111
64,1,57,42,44,86
65,1,57,29,39,68
66,1,57,17,10,27
67,1,57,24,34,58
68,1,57,51,51,102
69,1,57,65,50,115
70,1,57,49,38,87
71,1,57,80,116,196
72,1,57,6,4,10
73,1,57,54,52,106
74,1,57,27,24,51
75,1,57,11,34,45
76,1,57,22,22,44
77,1,57,33,38,71
78,1,57,24,25,49
79,1,57,19,17,36
80,1,57,27,30,57
81,1,57,24,52,76
82,1,57,34,23,57
83,1,57,46,54,100
84,1,57,26,17,43
85,1,57,29,38,67
86,1,57,20,15,35
87,1,57,98,121,219
88,1,57,11,26,37
89,1,57,26,19,45
90,1,57,48,48,96
91,1,57,81,83,164
92,1,57,12,26,38
93,1,57,29,37,66
94,1,57,13,11,24
95,1,57,3,9,12
96,1,57,39,44,83
97,1,57,41,46,87
98,1,57,11,15,26
99,1,57,54,61,115
100,1,57,62,65,127
101,1,57,60,75,135
102,1,57,28,16,44
103,1,57,57,49,106
104,1,57,18,23,41
105,1,57,23,20,43
106,1,57,20,34,54
107,1,57,31,81,112
108,1,57,45,72,117
109,1,57,26,33,59
110,1,57,41,28,69
111,1,57,61,76,137
112,1,57,21,16,37
113,1,57,17,31,48
114,1,57,46,54,100
115,1,57,42,62,104
116,1,57,34,32,66
117,1,57,20,21,41
118,1,57,28,33,61
119,1,57,58,66,124
120,1,57,16,26,42
121,1,57,50,27,77
122,1,57,19,3,22
123,1,57,85,138,223
124,1,57,0,4,4
125,1,57,30,27,57
126,1,57,29,19,48
127,1,57,17,8,25
128,1,57,8,12,20
129,1,57,58,51,109
130,1,57,32,38,70
131,1,57,53,70,123
132,1,57,28,27,55
133,1,57,19,32,51
134,1,57,47,61,108
135,1,57,33,42,75
136,1,57,13,26,39
137,1,57,8,4,12
138,1,57,25,35,60
139,1,57,23,10,33
140,1,57,80,123,203
141,1,57,113,122,235
142,1,57,38,29,67
143,1,57,28,24,52
144,1,57,10,6,16
145,1,57,36,28,64
146,1,57,22,29,51
147,1,57,9,17,26
148,1,57,7,5,12
149,1,57,22,41,63
150,1,57,9,41,50
151,1,57,26,23,49
152,1,57,31,40,71
153,1,57,10,16,26
154,1,57,66,75,141
155,1,57,82,56,138
156,1,57,38,23,61
157,1,57,31,11,42
158,1,57,14,13,27
159,1,57,27,30,57
160,1,57,24,14,38
161,1,57,54,42,96
162,1,57,5,11,16
163,1,57,11,21,32
164,1,57,12,17,29
165,1,57,27,11,38
166,1,57,109,106,215
167,1,57,13,14,27
168,1,57,9,10,19
169,1,57,6,13,19
170,1,57,104,89,193
171,1,57,27,19,46
172,1,57,11,13,24
173,1,57,83,96,179
174,1,57,29,43,72
175,1,57,34,17,51
176,1,57,9,15,24
177,1,57,29,30,59
178,1,57,26,11,37
179,1,57,15,19,34
180,1,57,13,16,29
181,1,57,47,46,93
182,1,57,19,15,34
183,1,57,51,40,91
184,1,57,114,49,163
185,1,57,7,5,12
186,1,57,92,72,164
187,1,57,101,169,270
188,1,57,75,85,160
189,1,57,0,0,0
190,1,57,27,29,56
191,1,57,36,31,67
192,1,57,18,11,29
193,1,57,26,40,66
194,1,57,36,33,69
195,1,57,50,48,98
196,1,57,27,21,48
197,1,57,13,20,33
198,1,57,42,22,64
199,1,57,1,0,1
200,1,57,12,25,37
201,1,57,51,57,108
202,1,57,0,1,1
203,1,57,94,85,179
204,1,57,108,89,197
205,1,57,9,16,25
206,1,57,0,6,6
207,1,57,65,34,99
208,1,57,1,5,6
209,1,57,124,118,242
210,1,57,1,3,4
211,1,57,69,38,107
212,1,57,0,0,0
213,1,57,20,27,47
214,1,57,24,10,34
215,1,57,116,94,210
216,1,57,1,2,3
217,1,57,17,8,25
218,1,57,29,37,66
219,1,57,30,34,64
220,1,57,29,28,57
221,1,57,104,135,239
222,1,57,130,119,249
223,1,57,34,72,106
224,1,57,10,14,24
225,1,57,3,3,6
226,1,57,72,68,140
227,1,57,0,1,1
228,1,57,17,21,38
229,1,57,5,5,10
230,1,57,26,28,54
231,1,57,51,40,91
232,1,57,26,21,47
233,1,57,52,71,123
234,1,57,68,48,116
235,1,57,3,3,6
236,1,57,34,22,56
237,1,57,89,139,228
238,1,57,31,35,66
239,1,57,19,21,40
240,1,57,91,63,154
241,1,57,26,36,62
242,1,57,58,39,97
243,1,57,38,58,96
244,1,57,33,41,74
245,1,57,48,48,96
246,1,57,9,32,41
247,1,57,47,31,78
248,1,57,79,47,126
249,1,57,58,44,102
250,1,57,27,28,55
251,1,57,9,13,22
252,1,57,22,19,41
253,1,57,44,58,102
254,1,57,42,24,66
255,1,57,21,14,35
256,1,57,54,19,73
257,1,57,187,149,336
258,1,57,0,0,0
259,1,57,296,222,518
260,1,57,39,17,56
261,1,57,4,3,7
262,1,57,8,18,26
263,1,57,25,40,65
264,1,57,0,4,4
265,1,57,3,1,4
266,1,57,21,17,38
267,1,57,0,1,1
268,1,57,4,6,10
269,1,57,79,78,157
270,1,57,0,0,0
271,1,57,2,0,2
272,1,57,39,41,80
273,1,57,85,53,138
274,1,57,23,31,54
275,1,57,19,30,49
276,1,57,3,7,10
277,1,57,51,56,107
278,1,57,11,9,20
279,1,57,89,74,163
280,1,57,6,3,9
281,1,57,17,12,29
282,1,57,0,4,4
283,1,57,87,58,145
284,1,57,33,31,64
285,1,57,1,3,4
286,1,57,19,18,37
287,1,57,54,68,122
288,1,57,0,2,2
289,1,57,123,132,255
290,1,57,0,0,0
291,1,57,29,28,57
292,1,57,4,10,14
293,1,57,0,0,0
294,1,57,49,38,87
295,1,57,18,17,35
296,1,57,90,78,168
297,1,57,80,91,171
298,1,57,68,79,147
299,1,57,120,127,247
300,1,57,17,10,27
301,1,57,17,5,22
302,1,57,34,28,62
303,1,57,21,12,33
304,1,57,0,2,2
305,1,57,15,23,38
306,1,57,27,19,46
307,1,57,1,3,4
308,1,57,43,28,71
309,1,57,74,54,128
310,1,57,54,46,100
311,1,57,22,32,54
312,1,57,13,18,31
313,1,57,15,14,29
314,1,57,0,0,0
315,1,57,93,90,183
316,1,57,50,38,88
317,1,57,18,17,35
318,1,57,15,24,39
319,1,57,0,1,1
320,1,57,41,46,87
321,1,57,1,4,5
322,1,57,28,13,41
323,1,57,0,0,0
324,1,57,42,56,98
325,1,57,61,40,101
326,1,57,18,19,37
327,1,57,16,10,26
328,1,57,30,30,60
329,1,57,22,27,49
330,1,57,42,34,76
331,1,57,256,171,427
332,1,57,8,7,15
333,1,57,21,25,46
334,1,57,51,44,95
335,1,57,45,66,111
336,1,57,52,45,97
337,1,57,20,18,38
338,1,57,22,39,61
339,1,57,11,24,35
340,1,57,5,10,15
341,1,57,15,14,29
342,1,57,37,51,88
343,1,57,21,20,41
344,1,57,86,75,161
345,1,57,93,110,203
346,1,57,51,35,86
347,1,57,39,22,61
348,1,57,40,32,72
349,1,57,36,32,68
350,1,57,8,19,27
351,1,57,13,18,31
352,1,57,13,24,37
353,1,57,33,30,63
354,1,57,18,25,43
355,1,57,39,17,56
356,1,57,52,62,114
357,1,57,6,12,18
358,1,57,33,33,66
359,1,57,20,34,54
360,1,57,24,40,64
361,1,57,11,9,20
362,1,57,51,80,131
363,1,57,8,7,15
364,1,57,49,47,96
365,1,57,55,49,104
366,1,57,50,16,66
367,1,57,56,65,121
368,1,57,16,13,29
369,1,57,24,24,48
370,1,57,4,5,9
371,1,57,60,29,89
372,1,57,36,36,72
373,1,57,15,10,25
374,1,57,48,21,69
375,1,57,24,22,46
376,1,57,85,93,178
377,1,57,89,109,198
378,1,57,14,33,47
379,1,57,27,30,57
380,1,57,41,25,66
381,1,57,4,7,11
382,1,57,39,24,63
383,1,57,17,12,29
384,1,57,55,53,108
385,1,57,6,13,19
386,1,57,29,38,67
387,1,57,12,14,26
388,1,57,18,15,33
389,1,57,0,0,0
390,1,57,275,195,470
391,1,57,6,13,19
392,1,57,11,15,26
393,1,57,58,72,130
394,1,57,24,30,54
395,1,57,54,32,86
396,1,57,33,31,64
397,1,57,16,11,27
398,1,57,27,52,79
399,1,57,13,11,24
400,1,57,8,8,16
401,1,57,7,5,12
402,1,57,6,8,14
403,1,57,19,20,39
404,1,57,4,5,9
405,1,57,112,123,235
406,1,57,38,45,83
407,1,57,1,5,6
408,1,57,39,53,92
409,1,57,12,15,27
410,1,57,29,51,80
411,1,57,66,53,119
412,1,57,1,3,4
413,1,57,6,14,20
414,1,57,10,17,27
415,1,57,8,20,28
416,1,57,50,50,100
417,1,57,3,7,10
418,1,57,39,40,79
419,1,57,44,48,92
420,1,57,74,119,193
421,1,57,76,57,133
422,1,57,30,39,69
423,1,57,0,3,3
424,1,57,1,1,2
0,1,60,183,131,314
1,1,60,26,25,51
2,1,60,65,47,112
3,1,60,40,57,97
4,1,60,29,45,74
5,1,60,88,90,178
6,1,60,25,41,66
7,1,60,41,45,86
8,1,60,56,54,110
9,1,60,22,35,57
10,1,60,65,80,145
11,1,60,32,27,59
12,1,60,20,37,57
13,1,60,70,67,137
14,1,60,33,34,67
15,1,60,79,40,119
16,1,60,75,73,148
17,1,60,62,54,116
18,1,60,49,50,99
19,1,60,34,31,65
20,1,60,28,18,46
21,1,60,52,34,86
22,1,60,7,24,31
23,1,60,34,46,80
24,1,60,73,69,142
25,1,60,27,48,75
26,1,60,68,74,142
27,1,60,29,47,76
28,1,60,72,58,130
29,1,60,75,98,173
30,1,60,29,45,74
31,1,60,33,40,73
32,1,60,82,100,182
33,1,60,146,133,279
34,1,60,19,20,39
35,1,60,67,55,122
36,1,60,66,98,164
37,1,60,9,17,26
38,1,60,6,2,8
39,1,60,38,36,74
40,1,60,26,15,41
41,1,60,26,30,56
42,1,60,58,91,149
43,1,60,30,43,73
44,1,60,11,8,19
45,1,60,37,28,65
46,1,60,44,47,91
47,1,60,6,17,23
48,1,60,56,32,88
49,1,60,56,80,136
50,1,60,6,29,35
51,1,60,33,70,103
52,1,60,52,76,128
53,1,60,0,0,0
54,1,60,12,11,23
55,1,60,69,60,129
56,1,60,8,7,15
57,1,60,67,52,119
58,1,60,34,36,70
59,1,60,101,64,165
60,1,60,23,34,57
61,1,60,80,83,163
62,1,60,36,38,74
63,1,60,61,64,125
64,1,60,43,62,105
65,1,60,31,38,69
66,1,60,9,12,21
67,1,60,31,37,68
68,1,60,65,62,127
69,1,60,71,66,137
70,1,60,41,30,71
71,1,60,108,95,203
72,1,60,1,2,3
73,1,60,57,56,113
74,1,60,35,28,63
75,1,60,17,22,39
76,1,60,24,22,46
77,1,60,27,44,71
78,1,60,20,24,44
79,1,60,9,17,26
80,1,60,39,33,72
81,1,60,35,36,71
82,1,60,32,43,75
83,1,60,40,55,95
84,1,60,21,16,37
85,1,60,39,91,130
86,1,60,24,17,41
87,1,60,93,123,216
88,1,60,10,24,34
89,1,60,30,22,52
90,1,60,55,53,108
91,1,60,92,61,153
92,1,60,8,29,37
93,1,60,39,49,88
94,1,60,11,12,23
95,1,60,2,3,5
96,1,60,58,43,101
97,1,60,31,46,77
98,1,60,19,14,33
99,1,60,64,77,141
100,1,60,71,70,141
101,1,60,71,70,141
102,1,60,30,18,48
103,1,60,48,53,101
104,1,60,14,30,44
105,1,60,41,30,71
106,1,60,12,26,38
107,1,60,34,61,95
108,1,60,54,64,118
109,1,60,23,27,50
110,1,60,53,30,83
111,1,60,71,82,153
112,1,60,20,26,46
113,1,60,17,28,45
114,1,60,39,53,92
115,1,60,54,63,117
116,1,60,22,25,47
117,1,60,21,28,49
118,1,60,31,39,70
119,1,60,61,70,131
120,1,60,18,30,48
121,1,60,47,43,90
122,1,60,20,20,40
123,1,60,78,140,218
124,1,60,0,1,1
125,1,60,37,22,59
126,1,60,24,28,52
127,1,60,17,10,27
128,1,60,17,21,38
129,1,60,52,49,101
130,1,60,43,61,104
131,1,60,59,63,122
132,1,60,24,27,51
133,1,60,18,39,57
134,1,60,50,55,105
135,1,60,42,41,83
136,1,60,26,34,60
137,1,60,3,4,7
138,1,60,29,26,55
139,1,60,19,13,32
140,1,60,109,129,238
141,1,60,117,144,261
142,1,60,25,23,48
143,1,60,15,19,34
144,1,60,15,4,19
145,1,60,32,48,80
146,1,60,19,28,47
147,1,60,7,22,29
148,1,60,2,6,8
149,1,60,14,42,56
150,1,60,11,25,36
151,1,60,30,21,51
152,1,60,34,33,67
153,1,60,10,17,27
154,1,60,71,64,135
155,1,60,71,41,112
156,1,60,29,33,62
157,1,60,27,23,50
158,1,60,21,14,35
159,1,60,27,33,60
160,1,60,23,20,43
161,1,60,62,53,115
162,1,60,10,10,20
163,1,60,12,25,37
164,1,60,19,22,41
165,1,60,18,5,23
166,1,60,90,58,148
167,1,60,9,10,19
168,1,60,5,17,22
169,1,60,11,15,26
170,1,60,104,110,214
171,1,60,21,14,35
172,1,60,12,14,26
173,1,60,85,81,166
174,1,60,23,30,53
175,1,60,23,14,37
176,1,60,4,9,13
177,1,60,37,33,70
178,1,60,23,10,33
179,1,60,15,17,32
180,1,60,27,20,47
181,1,60,37,55,92
182,1,60,12,14,26
183,1,60,71,62,133
184,1,60,93,48,141
185,1,60,17,28,45
186,1,60,107,76,183
187,1,60,113,109,222
188,1,60,101,94,195
189,1,60,0,1,1
190,1,60,18,34,52
191,1,60,30,37,67
192,1,60,37,25,62
193,1,60,26,45,71
194,1,60,40,48,88
195,1,60,47,61,108
196,1,60,28,26,54
197,1,60,11,19,30
198,1,60,33,15,48
199,1,60,0,0,0
200,1,60,10,30,40
201,1,60,63,47,110
202,1,60,0,0,0
203,1,60,86,70,156
204,1,60,133,125,258
205,1,60,7,19,26
206,1,60,0,4,4
207,1,60,40,48,88
208,1,60,0,1,1
209,1,60,118,96,214
210,1,60,3,5,8
211,1,60,76,62,138
212,1,60,1,2,3
213,1,60,28,25,53
214,1,60,32,9,41
215,1,60,92,67,159
216,1,60,1,3,4
217,1,60,7,8,15
218,1,60,22,26,48
219,1,60,35,36,71
220,1,60,18,12,30
221,1,60,94,126,220
222,1,60,118,139,257
223,1,60,22,34,56
224,1,60,14,6,20
225,1,60,3,4,7
226,1,60,65,70,135
227,1,60,0,4,4
228,1,60,12,12,24
229,1,60,4,7,11
230,1,60,25,33,58
231,1,60,59,46,105
232,1,60,20,32,52
233,1,60,53,88,141
234,1,60,62,47,109
235,1,60,3,0,3
236,1,60,38,35,73
237,1,60,95,92,187
238,1,60,29,23,52
239,1,60,22,20,42
240,1,60,91,54,145
241,1,60,27,21,48
242,1,60,47,39,86
243,1,60,30,50,80
244,1,60,55,65,120
245,1,60,52,42,94
246,1,60,18,26,44
247,1,60,59,29,88
248,1,60,85,41,126
249,1,60,55,42,97
250,1,60,26,28,54
251,1,60,12,23,35
252,1,60,11,19,30
253,1,60,48,57,105
254,1,60,49,21,70
255,1,60,20,16,36
256,1,60,55,30,85
257,1,60,107,159,266
258,1,60,0,1,1
259,1,60,288,207,495
260,1,60,33,13,46
261,1,60,4,7,11
262,1,60,12,22,34
263,1,60,39,38,77
264,1,60,2,2,4
265,1,60,6,2,8
266,1,60,15,7,22
267,1,60,2,2,4
268,1,60,5,4,9
269,1,60,67,50,117
270,1,60,0,0,0
271,1,60,0,1,1
272,1,60,41,46,87
273,1,60,109,64,173
274,1,60,29,34,63
275,1,60,20,27,47
276,1,60,4,11,15
277,1,60,55,66,121
278,1,60,7,7,14
279,1,60,75,61,136
280,1,60,4,8,12
281,1,60,25,21,46
282,1,60,1,2,3
283,1,60,89,53,142
284,1,60,18,47,65
285,1,60,3,7,10
286,1,60,39,16,55
287,1,60,60,43,103
288,1,60,3,5,8
289,1,60,147,73,220
290,1,60,0,1,1
291,1,60,15,26,41
292,1,60,2,9,11
293,1,60,0,3,3
294,1,60,51,44,95
295,1,60,25,20,45
296,1,60,91,93,184
297,1,60,76,68,144
298,1,60,35,44,79
299,1,60,166,98,264
300,1,60,14,22,36
301,1,60,16,12,28
302,1,60,30,32,62
303,1,60,14,18,32
304,1,60,0,0,0
305,1,60,20,31,51
306,1,60,25,25,50
307,1,60,1,1,2
308,1,60,26,21,47
309,1,60,84,32,116
310,1,60,66,32,98
311,1,60,35,19,54
312,1,60,26,19,45
313,1,60,9,10,19
314,1,60,1,1,2
315,1,60,93,105,198
316,1,60,44,33,77
317,1,60,18,15,33
318,1,60,14,29,43
319,1,60,0,4,4
320,1,60,53,43,96
321,1,60,1,4,5
322,1,60,32,20,52
323,1,60,0,1,1
324,1,60,59,29,88
325,1,60,60,35,95
326,1,60,24,14,38
327,1,60,24,26,50
328,1,60,31,40,71
329,1,60,21,20,41
330,1,60,46,24,70
331,1,60,207,160,367
332,1,60,14,10,24
333,1,60,12,31,43
334,1,60,56,52,108
335,1,60,45,56,101
336,1,60,53,46,99
337,1,60,10,13,23
338,1,60,25,26,51
339,1,60,16,24,40
340,1,60,7,11,18
341,1,60,15,14,29
342,1,60,44,48,92
343,1,60,21,8,29
344,1,60,97,60,157
345,1,60,92,96,188
346,1,60,37,44,81
347,1,60,52,19,71
348,1,60,43,40,83
349,1,60,28,31,59
350,1,60,18,23,41
351,1,60,15,48,63
352,1,60,23,23,46
353,1,60,52,63,115
354,1,60,20,15,35
355,1,60,26,18,44
356,1,60,96,61,157
357,1,60,5,16,21
358,1,60,27,46,73
359,1,60,15,36,51
360,1,60,36,44,80
361,1,60,10,8,18
362,1,60,62,63,125
363,1,60,12,10,22
364,1,60,64,71,135
365,1,60,64,46,110
366,1,60,49,30,79
367,1,60,57,87,144
368,1,60,10,16,26
369,1,60,30,20,50
370,1,60,3,4,7
371,1,60,46,49,95
372,1,60,27,20,47
373,1,60,17,24,41
374,1,60,42,57,99
375,1,60,38,26,64
376,1,60,89,63,152
377,1,60,116,118,234
378,1,60,21,29,50
379,1,60,28,32,60
380,1,60,41,29,70
381,1,60,6,18,24
382,1,60,23,45,68
383,1,60,30,16,46
384,1,60,49,74,123
385,1,60,10,14,24
386,1,60,32,35,67
387,1,60,12,20,32
388,1,60,14,22,36
389,1,60,0,0,0
390,1,60,266,171,437
391,1,60,6,17,23
392,1,60,17,25,42
393,1,60,52,46,98
394,1,60,21,33,54
395,1,60,51,41,92
396,1,60,23,19,42
397,1,60,7,15,22
398,1,60,36,42,78
399,1,60,14,14,28
400,1,60,8,8,16
401,1,60,7,6,13
402,1,60,9,8,17
403,1,60,20,27,47
404,1,60,1,6,7
405,1,60,126,133,259
406,1,60,36,50,86
407,1,60,4,10,14
408,1,60,48,67,115
409,1,60,17,11,28
410,1,60,20,40,60
411,1,60,57,50,107
412,1,60,1,3,4
413,1,60,10,15,25
414,1,60,5,14,19
415,1,60,16,21,37
416,1,60,36,46,82
417,1,60,3,3,6
418,1,60,57,35,92
419,1,60,47,47,94
420,1,60,82,96,178
421,1,60,71,69,140
422,1,60,37,53,90
423,1,60,0,3,3
424,1,60,0,0,0
0,1,63,176,110,286
1,1,63,22,30,52
2,1,63,98,55,153
3,1,63,68,75,143
4,1,63,62,61,123
5,1,63,140,157,297
6,1,63,36,29,65
7,1,63,45,63,108
8,1,63,53,60,113
9,1,63,33,55,88
10,1,63,76,109,185
11,1,63,13,23,36
12,1,63,43,36,79
13,1,63,71,90,161
14,1,63,30,38,68
15,1,63,75,28,103
16,1,63,79,79,158
17,1,63,69,80,149
18,1,63,72,75,147
19,1,63,23,38,61
20,1,63,28,36,64
21,1,63,71,42,113
22,1,63,11,18,29
23,1,63,34,55,89
24,1,63,74,79,153
25,1,63,47,65,112
26,1,63,96,75,171
27,1,63,31,47,78
28,1,63,61,79,140
29,1,63,71,95,166
30,1,63,42,39,81
31,1,63,47,48,95
32,1,63,119,127,246
33,1,63,148,118,266
34,1,63,25,28,53
35,1,63,80,59,139
36,1,63,70,101,171
37,1,63,11,18,29
38,1,63,9,5,14
39,1,63,48,40,88
40,1,63,28,16,44
41,1,63,25,32,57
42,1,63,61,108,169
43,1,63,31,40,71
44,1,63,15,9,24
45,1,63,45,19,64
46,1,63,46,65,111
47,1,63,7,8,15
48,1,63,58,34,92
49,1,63,57,117,174
50,1,63,13,29,42
51,1,63,53,69,122
52,1,63,59,76,135
53,1,63,1,1,2
54,1,63,16,13,29
55,1,63,72,61,133
56,1,63,6,13,19
57,1,63,52,57,109
58,1,63,31,32,63
59,1,63,63,61,124
60,1,63,36,42,78
61,1,63,59,57,116
62,1,63,37,30,67
63,1,63,74,67,141
64,1,63,46,72,118
65,1,63,33,31,64
66,1,63,20,14,34
67,1,63,26,29,55
68,1,63,55,69,124
69,1,63,113,96,209
70,1,63,50,36,86
71,1,63,92,82,174
72,1,63,4,12,16
73,1,63,104,82,186
74,1,63,30,31,61
75,1,63,11,17,28
76,1,63,23,18,41
77,1,63,37,56,93
78,1,63,27,22,49
79,1,63,19,23,42
80,1,63,29,29,58
81,1,63,31,30,61
82,1,63,26,36,62
83,1,63,41,61,102
84,1,63,22,9,31
85,1,63,46,83,129
86,1,63,16,8,24
87,1,63,97,133,230
88,1,63,16,50,66
89,1,63,25,10,35
90,1,63,44,33,77
91,1,63,89,59,148
92,1,63,14,49,63
93,1,63,39,39,78
94,1,63,14,24,38
95,1,63,4,4,8
96,1,63,66,44,110
97,1,63,29,30,59
98,1,63,23,22,45
99,1,63,71,83,154
100,1,63,68,63,131
101,1,63,60,79,139
102,1,63,19,20,39
103,1,63,60,51,111
104,1,63,22,38,60
105,1,63,36,20,56
106,1,63,12,41,53
107,1,63,53,62,115
108,1,63,76,71,147
109,1,63,20,30,50
110,1,63,52,18,70
111,1,63,64,71,135
112,1,63,19,22,41
113,1,63,17,30,47
114,1,63,41,37,78
115,1,63,47,71,118
116,1,63,24,35,59
117,1,63,18,22,40
118,1,63,32,49,81
119,1,63,80,73,153
120,1,63,20,34,54
121,1,63,32,17,49
122,1,63,27,23,50
123,1,63,100,142,242
124,1,63,0,3,3
125,1,63,31,33,64
126,1,63,24,28,52
127,1,63,35,22,57
128,1,63,13,15,28
129,1,63,49,46,95
130,1,63,29,57,86
131,1,63,62,58,120
132,1,63,35,33,68
133,1,63,24,33,57
134,1,63,55,71,126
135,1,63,59,53,112
136,1,63,16,25,41
137,1,63,7,4,11
138,1,63,29,24,53
139,1,63,22,20,42
140,1,63,110,146,256
141,1,63,135,184,319
142,1,63,27,16,43
143,1,63,19,29,48
144,1,63,8,7,15
145,1,63,32,46,78
146,1,63,24,33,57
147,1,63,11,19,30
148,1,63,4,6,10
149,1,63,28,46,74
150,1,63,4,18,22
151,1,63,28,21,49
152,1,63,24,54,78
153,1,63,12,10,22
154,1,63,74,83,157
155,1,63,69,53,122
156,1,63,23,21,44
157,1,63,35,24,59
158,1,63,21,14,35
159,1,63,21,36,57
160,1,63,20,18,38
161,1,63,54,54,108
162,1,63,1,11,12
163,1,63,15,24,39
164,1,63,22,24,46
165,1,63,17,4,21
166,1,63,65,31,96
167,1,63,7,14,21
168,1,63,3,10,13
169,1,63,10,18,28
170,1,63,100,106,206
171,1,63,15,14,29
172,1,63,9,18,27
173,1,63,128,106,234
174,1,63,31,43,74
175,1,63,32,19,51
176,1,63,11,6,17
177,1,63,30,31,61
178,1,63,19,12,31
179,1,63,9,16,25
180,1,63,27,22,49
181,1,63,42,68,110
182,1,63,26,21,47
183,1,63,59,47,106
184,1,63,134,61,195
185,1,63,22,20,42
186,1,63,84,72,156
187,1,63,145,111,256
188,1,63,90,98,188
189,1,63,2,0,2
190,1,63,19,41,60
191,1,63,26,44,70
192,1,63,21,31,52
193,1,63,25,35,60
194,1,63,57,60,117
195,1,63,53,79,132
196,1,63,21,34,55
197,1,63,10,20,30
198,1,63,38,7,45
199,1,63,0,0,0
200,1,63,13,32,45
201,1,63,67,55,122
202,1,63,1,0,1
203,1,63,76,58,134
204,1,63,140,123,263
205,1,63,7,20,27
206,1,63,0,2,2
207,1,63,56,55,111
208,1,63,0,0,0
209,1,63,123,106,229
210,1,63,2,3,5
211,1,63,57,54,111
212,1,63,1,1,2
213,1,63,27,24,51
214,1,63,31,20,51
215,1,63,90,69,159
216,1,63,5,7,12
217,1,63,3,5,8
218,1,63,43,16,59
219,1,63,31,39,70
220,1,63,12,8,20
221,1,63,113,156,269
222,1,63,159,137,296
223,1,63,38,21,59
224,1,63,14,5,19
225,1,63,2,0,2
226,1,63,73,96,169
227,1,63,0,3,3
228,1,63,16,22,38
229,1,63,7,9,16
230,1,63,25,34,59
231,1,63,49,42,91
232,1,63,20,28,48
233,1,63,82,76,158
234,1,63,51,41,92
235,1,63,3,1,4
236,1,63,23,32,55
237,1,63,55,51,106
238,1,63,31,19,50
239,1,63,13,15,28
240,1,63,73,38,111
241,1,63,37,29,66
242,1,63,61,29,90
243,1,63,31,82,113
244,1,63,66,58,124
245,1,63,57,34,91
246,1,63,15,22,37
247,1,63,46,21,67
248,1,63,60,37,97
249,1,63,51,47,98
250,1,63,32,22,54
251,1,63,5,15,20
252,1,63,12,21,33
253,1,63,54,36,90
254,1,63,38,24,62
255,1,63,21,14,35
256,1,63,37,22,59
257,1,63,133,189,322
258,1,63,0,0,0
259,1,63,241,150,391
260,1,63,26,10,36
261,1,63,6,8,14
262,1,63,13,24,37
263,1,63,34,38,72
264,1,63,0,4,4
265,1,63,4,5,9
266,1,63,15,8,23
267,1,63,1,2,3
268,1,63,6,2,8
269,1,63,44,29,73
270,1,63,1,0,1
271,1,63,0,1,1
272,1,63,42,48,90
273,1,63,101,45,146
274,1,63,15,27,42
275,1,63,22,21,43
276,1,63,10,14,24
277,1,63,52,56,108
278,1,63,19,5,24
279,1,63,79,63,142
280,1,63,4,10,14
281,1,63,21,14,35
282,1,63,0,1,1
283,1,63,62,69,131
284,1,63,52,46,98
285,1,63,5,5,10
286,1,63,24,16,40
287,1,63,44,31,75
288,1,63,4,3,7
289,1,63,85,38,123
290,1,63,0,0,0
291,1,63,20,17,37
292,1,63,8,8,16
293,1,63,0,2,2
294,1,63,68,49,117
295,1,63,10,8,18
296,1,63,74,72,146
297,1,63,40,39,79
298,1,63,24,52,76
299,1,63,83,34,117
300,1,63,16,15,31
301,1,63,13,10,23
302,1,63,27,17,44
303,1,63,15,22,37
304,1,63,0,0,0
305,1,63,19,44,63
306,1,63,26,18,44
307,1,63,2,5,7
308,1,63,17,23,40
309,1,63,50,24,74
310,1,63,39,17,56
311,1,63,23,21,44
312,1,63,22,26,48
313,1,63,17,9,26
314,1,63,1,2,3
315,1,63,73,91,164
316,1,63,36,19,55
317,1,63,23,14,37
318,1,63,14,31,45
319,1,63,0,3,3
320,1,63,51,28,79
321,1,63,0,3,3
322,1,63,16,16,32
323,1,63,0,1,1
324,1,63,49,30,79
325,1,63,53,30,83
326,1,63,15,9,24
327,1,63,13,18,31
328,1,63,28,42,70
329,1,63,21,33,54
330,1,63,38,30,68
331,1,63,202,99,301
332,1,63,17,11,28
333,1,63,11,32,43
334,1,63,45,40,85
335,1,63,68,71,139
336,1,63,67,33,100
337,1,63,10,12,22
338,1,63,14,30,44
339,1,63,29,18,47
340,1,63,2,15,17
341,1,63,12,11,23
342,1,63,36,28,64
343,1,63,13,6,19
344,1,63,71,52,123
345,1,63,93,66,159
346,1,63,37,47,84
347,1,63,48,17,65
348,1,63,41,37,78
349,1,63,19,37,56
350,1,63,13,19,32
351,1,63,22,29,51
352,1,63,18,28,46
353,1,63,43,42,85
354,1,63,19,21,40
355,1,63,33,31,64
356,1,63,87,45,132
357,1,63,5,18,23
358,1,63,40,50,90
359,1,63,17,25,42
360,1,63,41,49,90
361,1,63,9,18,27
362,1,63,55,55,110
363,1,63,12,18,30
364,1,63,54,58,112
365,1,63,64,61,125
366,1,63,45,23,68
367,1,63,69,89,158
368,1,63,5,15,20
369,1,63,25,23,48
370,1,63,3,5,8
371,1,63,35,42,77
372,1,63,27,16,43
373,1,63,19,25,44
374,1,63,46,34,80
375,1,63,24,26,50
376,1,63,72,53,125
377,1,63,95,113,208
378,1,63,26,20,46
379,1,63,20,30,50
380,1,63,42,26,68
381,1,63,7,10,17
382,1,63,29,41,70
383,1,63,23,17,40
384,1,63,58,67,125
385,1,63,9,23,32
386,1,63,45,46,91
387,1,63,13,14,27
388,1,63,19,29,48
389,1,63,0,1,1
390,1,63,246,141,387
391,1,63,4,13,17
392,1,63,13,18,31
393,1,63,63,56,119
394,1,63,19,36,55
395,1,63,39,22,61
396,1,63,21,23,44
397,1,63,3,11,14
398,1,63,27,40,67
399,1,63,16,10,26
400,1,63,9,15,24
401,1,63,8,7,15
402,1,63,7,16,23
403,1,63,21,24,45
404,1,63,5,6,11
405,1,63,117,120,237
406,1,63,32,51,83
407,1,63,6,9,15
408,1,63,47,77,124
409,1,63,13,16,29
410,1,63,29,72,101
411,1,63,44,58,102
412,1,63,0,3,3
413,1,63,5,5,10
414,1,63,5,11,16
415,1,63,5,33,38
416,1,63,48,49,97
417,1,63,1,6,7
418,1,63,44,36,80
419,1,63,46,35,81
420,1,63,82,83,165
421,1,63,64,55,119
422,1,63,36,58,94
423,1,63,1,5,6
424,1,63,1,1,2
0,1,66,178,109,287
1,1,66,24,23,47
2,1,66,96,51,147
3,1,66,57,90,147
4,1,66,40,66,106
5,1,66,116,132,248
6,1,66,46,45,91
7,1,66,47,70,117
8,1,66,55,63,118
9,1,66,28,66,94
10,1,66,85,88,173
11,1,66,14,17,31
12,1,66,37,49,86
13,1,66,62,82,144
14,1,66,38,47,85
15,1,66,66,41,107
16,1,66,66,89,155
17,1,66,64,64,128
18,1,66,69,89,158
19,1,66,28,44,72
20,1,66,41,22,63
21,1,66,71,27,98
22,1,66,13,16,29
23,1,66,34,61,95
24,1,66,61,94,155
25,1,66,31,71,102
26,1,66,101,91,192
27,1,66,33,48,81
28,1,66,68,80,148
29,1,66,66,89,155
30,1,66,31,31,62
31,1,66,38,47,85
32,1,66,122,114,236
33,1,66,104,113,217
34,1,66,40,20,60
35,1,66,74,64,138
36,1,66,66,136,202
37,1,66,10,22,32
38,1,66,9,9,18
39,1,66,25,42,67
40,1,66,27,22,49
41,1,66,28,30,58
42,1,66,62,122,184
43,1,66,41,46,87
44,1,66,11,12,23
45,1,66,52,60,112
46,1,66,42,60,102
47,1,66,10,5,15
48,1,66,59,59,118
49,1,66,66,120,186
50,1,66,6,29,35
51,1,66,48,78,126
52,1,66,67,68,135
53,1,66,0,0,0
54,1,66,17,7,24
55,1,66,84,49,133
56,1,66,7,15,22
57,1,66,46,65,111
58,1,66,49,38,87
59,1,66,70,78,148
60,1,66,28,41,69
61,1,66,63,54,117
62,1,66,24,32,56
63,1,66,64,56,120
64,1,66,70,72,142
65,1,66,46,49,95
66,1,66,21,11,32
67,1,66,25,40,65
68,1,66,55,75,130
69,1,66,113,80,193
70,1,66,70,36,106
71,1,66,84,72,156
72,1,66,4,4,8
73,1,66,98,74,172
74,1,66,31,32,63
75,1,66,22,27,49
76,1,66,21,31,52
77,1,66,28,72,100
78,1,66,24,13,37
79,1,66,15,14,29
80,1,66,26,30,56
81,1,66,47,21,68
82,1,66,47,31,78
83,1,66,39,50,89
84,1,66,18,12,30
85,1,66,61,80,141
86,1,66,21,14,35
87,1,66,118,111,229
88,1,66,23,29,52
89,1,66,35,27,62
90,1,66,52,29,81
91,1,66,73,47,120
92,1,66,20,53,73
93,1,66,15,39,54
94,1,66,9,11,20
95,1,66,2,4,6
96,1,66,51,29,80
97,1,66,39,26,65
98,1,66,15,20,35
99,1,66,55,53,108
100,1,66,66,69,135
101,1,66,79,94,173
102,1,66,23,28,51
103,1,66,62,40,102
104,1,66,19,43,62
105,1,66,42,25,67
106,1,66,18,43,61
107,1,66,47,44,91
108,1,66,52,68,120
109,1,66,19,23,42
110,1,66,36,16,52
111,1,66,93,70,163
112,1,66,23,42,65
113,1,66,7,18,25
114,1,66,49,66,115
115,1,66,29,45,74
116,1,66,23,31,54
117,1,66,13,32,45
118,1,66,32,44,76
119,1,66,68,87,155
120,1,66,18,30,48
121,1,66,42,23,65
122,1,66,31,19,50
123,1,66,88,109,197
124,1,66,1,3,4
125,1,66,36,19,55
126,1,66,23,24,47
127,1,66,22,13,35
128,1,66,11,17,28
129,1,66,65,52,117
130,1,66,42,84,126
131,1,66,57,70,127
132,1,66,31,23,54
133,1,66,18,27,45
134,1,66,49,54,103
135,1,66,50,54,104
136,1,66,20,29,49
137,1,66,7,13,20
138,1,66,31,20,51
139,1,66,17,18,35
140,1,66,106,112,218
141,1,66,125,186,311
142,1,66,28,21,49
143,1,66,9,22,31
144,1,66,9,5,14
145,1,66,37,49,86
146,1,66,26,38,64
147,1,66,9,24,33
148,1,66,7,5,12
149,1,66,25,48,73
150,1,66,7,11,18
151,1,66,31,46,77
152,1,66,21,38,59
153,1,66,7,5,12
154,1,66,74,73,147
155,1,66,78,48,126
156,1,66,24,34,58
157,1,66,32,27,59
158,1,66,22,11,33
159,1,66,35,37,72
160,1,66,35,13,48
161,1,66,63,64,127
162,1,66,8,11,19
163,1,66,13,16,29
164,1,66,15,20,35
165,1,66,8,1,9
166,1,66,65,18,83
167,1,66,6,10,16
168,1,66,5,13,18
169,1,66,20,20,40
170,1,66,95,99,194
171,1,66,4,15,19
172,1,66,7,7,14
173,1,66,80,77,157
174,1,66,25,27,52
175,1,66,37,21,58
176,1,66,5,13,18
177,1,66,35,43,78
178,1,66,16,8,24
179,1,66,9,14,23
180,1,66,22,20,42
181,1,66,44,82,126
182,1,66,13,12,25
183,1,66,53,46,99
184,1,66,119,48,167
185,1,66,17,19,36
186,1,66,100,71,171
187,1,66,141,106,247
188,1,66,79,100,179
189,1,66,0,0,0
190,1,66,22,41,63
191,1,66,28,19,47
192,1,66,15,22,37
193,1,66,29,36,65
194,1,66,32,41,73
195,1,66,37,70,107
196,1,66,17,23,40
197,1,66,17,34,51
198,1,66,44,12,56
199,1,66,1,1,2
200,1,66,9,34,43
201,1,66,57,64,121
202,1,66,0,1,1
203,1,66,79,63,142
204,1,66,124,129,253
205,1,66,7,25,32
206,1,66,3,6,9
207,1,66,34,64,98
208,1,66,0,2,2
209,1,66,104,100,204
210,1,66,3,2,5
211,1,66,72,46,118
212,1,66,0,0,0
213,1,66,17,17,34
214,1,66,35,18,53
215,1,66,88,57,145
216,1,66,6,3,9
217,1,66,3,5,8
218,1,66,27,7,34
219,1,66,26,23,49
220,1,66,7,3,10
221,1,66,104,133,237
222,1,66,125,176,301
223,1,66,25,16,41
224,1,66,17,3,20
225,1,66,0,1,1
226,1,66,68,102,170
227,1,66,1,3,4
228,1,66,11,26,37
229,1,66,6,9,15
230,1,66,15,26,41
231,1,66,40,51,91
232,1,66,18,23,41
233,1,66,86,100,186
234,1,66,44,28,72
235,1,66,2,2,4
236,1,66,29,27,56
237,1,66,53,34,87
238,1,66,44,19,63
239,1,66,20,16,36
240,1,66,64,28,92
241,1,66,33,26,59
242,1,66,40,15,55
243,1,66,38,75,113
244,1,66,64,57,121
245,1,66,53,37,90
246,1,66,18,22,40
247,1,66,45,19,64
248,1,66,86,48,134
249,1,66,41,29,70
250,1,66,24,31,55
251,1,66,11,23,34
252,1,66,14,28,42
253,1,66,38,30,68
254,1,66,32,24,56
255,1,66,27,13,40
256,1,66,28,28,56
257,1,66,153,94,247
258,1,66,0,0,0
259,1,66,247,132,379
260,1,66,19,15,34
261,1,66,5,9,14
262,1,66,15,30,45
263,1,66,37,29,66
264,1,66,1,8,9
265,1,66,2,4,6
266,1,66,11,11,22
267,1,66,0,0,0
268,1,66,4,4,8
269,1,66,48,16,64
270,1,66,0,0,0
271,1,66,0,2,2
272,1,66,56,38,94
273,1,66,93,50,143
274,1,66,25,28,53
275,1,66,19,9,28
276,1,66,9,7,16
277,1,66,42,54,96
278,1,66,18,5,23
279,1,66,81,37,118
280,1,66,4,10,14
281,1,66,22,9,31
282,1,66,0,0,0
283,1,66,45,53,98
284,1,66,28,41,69
285,1,66,1,6,7
286,1,66,13,11,24
287,1,66,27,15,42
288,1,66,1,4,5
289,1,66,75,32,107
290,1,66,0,1,1
291,1,66,13,20,33
292,1,66,1,5,6
293,1,66,0,2,2
294,1,66,55,42,97
295,1,66,12,8,20
296,1,66,64,56,120
297,1,66,48,20,68
298,1,66,22,45,67
299,1,66,70,29,99
300,1,66,15,16,31
301,1,66,12,9,21
302,1,66,25,20,45
303,1,66,8,17,25
304,1,66,0,3,3
305,1,66,24,45,69
306,1,66,28,17,45
307,1,66,1,3,4
308,1,66,29,19,48
309,1,66,24,16,40
310,1,66,56,34,90
311,1,66,28,21,49
312,1,66,21,27,48
313,1,66,16,11,27
314,1,66,0,0,0
315,1,66,96,100,196
316,1,66,25,28,53
317,1,66,17,14,31
318,1,66,18,17,35
319,1,66,0,1,1
320,1,66,36,22,58
321,1,66,1,5,6
322,1,66,13,15,28
323,1,66,0,1,1
324,1,66,45,18,63
325,1,66,49,23,72
326,1,66,11,3,14
327,1,66,15,12,27
328,1,66,22,39,61
329,1,66,18,38,56
330,1,66,20,39,59
331,1,66,207,95,302
332,1,66,11,8,19
333,1,66,13,31,44
334,1,66,67,43,110
335,1,66,61,70,131
336,1,66,42,34,76
337,1,66,8,18,26
338,1,66,16,23,39
339,1,66,15,20,35
340,1,66,10,15,25
341,1,66,9,11,20
342,1,66,33,26,59
343,1,66,6,3,9
344,1,66,52,37,89
345,1,66,104,48,152
346,1,66,43,35,78
347,1,66,43,19,62
348,1,66,51,35,86
349,1,66,29,50,79
350,1,66,10,37,47
351,1,66,11,33,44
352,1,66,10,30,40
353,1,66,39,45,84
354,1,66,15,22,37
355,1,66,25,28,53
356,1,66,84,36,120
357,1,66,6,8,14
358,1,66,28,41,69
359,1,66,22,36,58
360,1,66,34,51,85
361,1,66,7,12,19
362,1,66,59,35,94
363,1,66,6,17,23
364,1,66,43,51,94
365,1,66,61,36,97
366,1,66,41,14,55
367,1,66,59,58,117
368,1,66,10,13,23
369,1,66,31,23,54
370,1,66,2,4,6
371,1,66,34,52,86
372,1,66,25,12,37
373,1,66,11,19,30
374,1,66,39,29,68
375,1,66,19,28,47
376,1,66,77,55,132
377,1,66,89,80,169
378,1,66,12,14,26
379,1,66,28,33,61
380,1,66,37,25,62
381,1,66,4,14,18
382,1,66,22,28,50
383,1,66,16,11,27
384,1,66,57,51,108
385,1,66,3,8,11
386,1,66,44,33,77
387,1,66,12,13,25
388,1,66,19,15,34
389,1,66,0,0,0
390,1,66,180,86,266
391,1,66,6,21,27
392,1,66,5,20,25
393,1,66,62,62,124
394,1,66,15,26,41
395,1,66,42,22,64
396,1,66,21,11,32
397,1,66,4,6,10
398,1,66,20,39,59
399,1,66,14,7,21
400,1,66,9,6,15
401,1,66,5,6,11
402,1,66,9,17,26
403,1,66,23,40,63
404,1,66,0,2,2
405,1,66,98,136,234
406,1,66,30,58,88
407,1,66,7,14,21
408,1,66,58,72,130
409,1,66,15,17,32
410,1,66,33,66,99
411,1,66,64,66,130
412,1,66,1,2,3
413,1,66,6,8,14
414,1,66,2,8,10
415,1,66,14,36,50
416,1,66,38,50,88
417,1,66,3,16,19
418,1,66,28,24,52
419,1,66,45,43,88
420,1,66,95,56,151
421,1,66,77,64,141
422,1,66,26,50,76
423,1,66,3,6,9
424,1,66,0,0,0
0,1,69,66,58,124
1,1,69,23,25,48
2,1,69,53,28,81
3,1,69,38,57,95
4,1,69,27,30,57
5,1,69,92,99,191
6,1,69,33,24,57
7,1,69,20,32,52
8,1,69,35,35,70
9,1,69,19,38,57
10,1,69,61,88,149
11,1,69,10,23,33
12,1,69,12,29,41
13,1,69,43,56,99
14,1,69,38,36,74
15,1,69,31,20,51
16,1,69,45,62,107
17,1,69,76,50,126
18,1,69,42,49,91
19,1,69,28,26,54
20,1,69,18,25,43
21,1,69,37,25,62
22,1,69,5,8,13
23,1,69,22,38,60
24,1,69,60,79,139
25,1,69,32,54,86
26,1,69,86,53,139
27,1,69,31,40,71
28,1,69,36,61,97
29,1,69,54,86,140
30,1,69,31,24,55
31,1,69,20,30,50
32,1,69,76,68,144
33,1,69,50,62,112
34,1,69,19,11,30
35,1,69,50,59,109
36,1,69,42,73,115
37,1,69,13,9,22
38,1,69,2,1,3
39,1,69,17,27,44
40,1,69,12,11,23
41,1,69,16,15,31
42,1,69,47,81,128
43,1,69,31,46,77
44,1,69,5,6,11
45,1,69,42,44,86
46,1,69,23,29,52
47,1,69,8,9,17
48,1,69,53,29,82
49,1,69,50,87,137
50,1,69,6,26,32
51,1,69,34,43,77
52,1,69,43,47,90
53,1,69,0,2,2
54,1,69,9,8,17
55,1,69,47,37,84
56,1,69,8,16,24
57,1,69,39,45,84
58,1,69,30,37,67
59,1,69,51,56,107
60,1,69,29,23,52
61,1,69,20,20,40
62,1,69,50,45,95
63,1,69,57,35,92
64,1,69,21,30,51
65,1,69,35,37,72
66,1,69,14,11,25
67,1,69,26,20,46
68,1,69,48,49,97
69,1,69,71,46,117
70,1,69,34,21,55
71,1,69,59,59,118
72,1,69,4,3,7
73,1,69,45,39,84
74,1,69,23,30,53
75,1,69,34,18,52
76,1,69,18,18,36
77,1,69,29,42,71
78,1,69,8,24,32
79,1,69,4,10,14
80,1,69,27,16,43
81,1,69,42,26,68
82,1,69,24,26,50
83,1,69,29,35,64
84,1,69,12,2,14
85,1,69,60,75,135
86,1,69,7,8,15
87,1,69,140,136,276
88,1,69,10,24,34
89,1,69,22,16,38
90,1,69,23,17,40
91,1,69,60,40,100
92,1,69,8,38,46
93,1,69,12,28,40
94,1,69,3,5,8
95,1,69,2,0,2
96,1,69,27,18,45
97,1,69,18,33,51
98,1,69,5,8,13
99,1,69,44,25,69
100,1,69,48,45,93
101,1,69,53,50,103
102,1,69,9,10,19
103,1,69,38,31,69
104,1,69,6,23,29
105,1,69,28,19,47
106,1,69,12,26,38
107,1,69,48,31,79
108,1,69,42,45,87
109,1,69,17,25,42
110,1,69,17,13,30
111,1,69,83,53,136
112,1,69,18,19,37
113,1,69,9,20,29
114,1,69,45,54,99
115,1,69,44,51,95
116,1,69,12,18,30
117,1,69,22,24,46
118,1,69,39,45,84
119,1,69,55,58,113
120,1,69,18,31,49
121,1,69,23,12,35
122,1,69,18,13,31
123,1,69,47,73,120
124,1,69,1,2,3
125,1,69,13,21,34
126,1,69,13,19,32
127,1,69,5,10,15
128,1,69,3,11,14
129,1,69,37,41,78
130,1,69,27,42,69
131,1,69,39,48,87
132,1,69,13,10,23
133,1,69,8,14,22
134,1,69,64,40,104
135,1,69,39,43,82
136,1,69,18,24,42
137,1,69,2,7,9
138,1,69,18,10,28
139,1,69,9,16,25
140,1,69,50,74,124
141,1,69,77,126,203
142,1,69,8,10,18
143,1,69,12,14,26
144,1,69,3,3,6
145,1,69,18,36,54
146,1,69,9,26,35
147,1,69,9,17,26
148,1,69,3,3,6
149,1,69,17,39,56
150,1,69,13,11,24
151,1,69,17,17,34
152,1,69,12,27,39
153,1,69,1,5,6
154,1,69,44,53,97
155,1,69,45,27,72
156,1,69,19,20,39
157,1,69,17,20,37
158,1,69,13,11,24
159,1,69,20,34,54
160,1,69,14,16,30
161,1,69,43,52,95
162,1,69,2,3,5
163,1,69,9,10,19
164,1,69,20,13,33
165,1,69,3,1,4
166,1,69,63,25,88
167,1,69,3,6,9
168,1,69,1,8,9
169,1,69,8,7,15
170,1,69,69,70,139
171,1,69,3,9,12
172,1,69,5,3,8
173,1,69,72,63,135
174,1,69,17,8,25
175,1,69,25,14,39
176,1,69,4,4,8
177,1,69,31,34,65
178,1,69,5,2,7
179,1,69,7,4,11
180,1,69,17,15,32
181,1,69,32,39,71
182,1,69,5,4,9
183,1,69,60,58,118
184,1,69,78,43,121
185,1,69,13,6,19
186,1,69,59,38,97
187,1,69,96,81,177
188,1,69,54,80,134
189,1,69,0,0,0
190,1,69,24,43,67
191,1,69,15,11,26
192,1,69,27,9,36
193,1,69,20,20,40
194,1,69,33,36,69
195,1,69,30,49,79
196,1,69,20,12,32
197,1,69,6,16,22
198,1,69,19,13,32
199,1,69,0,0,0
200,1,69,13,36,49
201,1,69,47,28,75
202,1,69,0,0,0
203,1,69,61,46,107
204,1,69,101,102,203
205,1,69,10,18,28
206,1,69,0,3,3
207,1,69,28,40,68
208,1,69,1,0,1
209,1,69,89,58,147
210,1,69,1,2,3
211,1,69,66,51,117
212,1,69,0,0,0
213,1,69,13,14,27
214,1,69,22,17,39
215,1,69,67,34,101
216,1,69,0,1,1
217,1,69,4,2,6
218,1,69,11,3,14
219,1,69,14,20,34
220,1,69,2,0,2
221,1,69,83,121,204
222,1,69,102,98,200
223,1,69,27,9,36
224,1,69,8,2,10
225,1,69,0,1,1
226,1,69,49,62,111
227,1,69,0,0,0
228,1,69,11,11,22
229,1,69,3,13,16
230,1,69,16,29,45
231,1,69,43,47,90
232,1,69,16,22,38
233,1,69,71,64,135
234,1,69,21,16,37
235,1,69,0,0,0
236,1,69,22,20,42
237,1,69,39,25,64
238,1,69,13,10,23
239,1,69,16,12,28
240,1,69,35,16,51
241,1,69,29,10,39
242,1,69,13,12,25
243,1,69,28,75,103
244,1,69,43,32,75
245,1,69,29,28,57
246,1,69,17,14,31
247,1,69,37,19,56
248,1,69,55,18,73
249,1,69,39,27,66
250,1,69,20,12,32
251,1,69,6,12,18
252,1,69,10,20,30
253,1,69,38,21,59
254,1,69,14,18,32
255,1,69,14,13,27
256,1,69,22,9,31
257,1,69,45,44,89
258,1,69,0,2,2
259,1,69,161,121,282
260,1,69,11,3,14
261,1,69,5,7,12
262,1,69,13,24,37
263,1,69,40,22,62
264,1,69,4,2,6
265,1,69,1,2,3
266,1,69,6,10,16
267,1,69,1,1,2
268,1,69,2,4,6
269,1,69,23,10,33
270,1,69,0,0,0
271,1,69,1,1,2
272,1,69,33,28,61
273,1,69,70,39,109
274,1,69,26,25,51
275,1,69,19,14,33
276,1,69,3,8,11
277,1,69,35,46,81
278,1,69,3,2,5
279,1,69,51,19,70
280,1,69,8,14,22
281,1,69,9,2,11
282,1,69,0,0,0
283,1,69,28,58,86
284,1,69,24,30,54
285,1,69,4,1,5
286,1,69,16,8,24
287,1,69,31,5,36
288,1,69,0,3,3
289,1,69,47,25,72
290,1,69,0,0,0
291,1,69,10,17,27
292,1,69,0,5,5
293,1,69,0,0,0
294,1,69,36,39,75
295,1,69,10,5,15
296,1,69,62,14,76
297,1,69,45,16,61
298,1,69,29,38,67
299,1,69,45,23,68
300,1,69,12,21,33
301,1,69,10,6,16
302,1,69,21,11,32
303,1,69,12,10,22
304,1,69,0,0,0
305,1,69,10,23,33
306,1,69,19,15,34
307,1,69,0,0,0
308,1,69,15,12,27
309,1,69,11,5,16
310,1,69,54,30,84
311,1,69,21,17,38
312,1,69,17,13,30
313,1,69,11,9,20
314,1,69,0,0,0
315,1,69,63,83,146
316,1,69,18,18,36
317,1,69,10,2,12
318,1,69,9,18,27
319,1,69,1,1,2
320,1,69,17,12,29
321,1,69,0,1,1
322,1,69,17,14,31
323,1,69,0,0,0
324,1,69,17,14,31
325,1,69,29,16,45
326,1,69,17,8,25
327,1,69,10,7,17
328,1,69,17,30,47
329,1,69,21,20,41
330,1,69,15,21,36
331,1,69,145,79,224
332,1,69,5,7,12
333,1,69,6,21,27
334,1,69,33,34,67
335,1,69,40,64,104
336,1,69,32,32,64
337,1,69,8,14,22
338,1,69,10,21,31
339,1,69,8,17,25
340,1,69,10,10,20
341,1,69,10,8,18
342,1,69,47,11,58
343,1,69,8,3,11
344,1,69,47,36,83
345,1,69,72,27,99
346,1,69,41,43,84
347,1,69,22,15,37
348,1,69,29,23,52
349,1,69,26,20,46
350,1,69,14,27,41
351,1,69,7,20,27
352,1,69,11,22,33
353,1,69,34,41,75
354,1,69,9,13,22
355,1,69,14,16,30
356,1,69,48,28,76
357,1,69,0,3,3
358,1,69,19,24,43
359,1,69,23,17,40
360,1,69,28,37,65
361,1,69,9,11,20
362,1,69,43,32,75
363,1,69,8,14,22
364,1,69,22,40,62
365,1,69,36,27,63
366,1,69,22,14,36
367,1,69,51,46,97
368,1,69,6,9,15
369,1,69,20,14,34
370,1,69,3,6,9
371,1,69,25,25,50
372,1,69,17,16,33
373,1,69,6,17,23
374,1,69,19,21,40
375,1,69,13,18,31
376,1,69,49,32,81
377,1,69,82,57,139
378,1,69,18,4,22
379,1,69,22,20,42
380,1,69,27,11,38
381,1,69,3,8,11
382,1,69,14,23,37
383,1,69,9,10,19
384,1,69,37,29,66
385,1,69,8,5,13
386,1,69,31,24,55
387,1,69,10,6,16
388,1,69,8,12,20
389,1,69,0,0,0
390,1,69,123,81,204
391,1,69,6,12,18
392,1,69,2,9,11
393,1,69,45,51,96
394,1,69,13,22,35
395,1,69,17,21,38
396,1,69,9,6,15
397,1,69,3,5,8
398,1,69,8,18,26
399,1,69,4,3,7
400,1,69,3,4,7
401,1,69,1,1,2
402,1,69,7,14,21
403,1,69,16,30,46
404,1,69,0,0,0
405,1,69,97,117,214
406,1,69,34,43,77
407,1,69,4,9,13
408,1,69,47,57,104
409,1,69,11,10,21
410,1,69,37,63,100
411,1,69,62,43,105
412,1,69,0,3,3
413,1,69,8,13,21
414,1,69,4,7,11
415,1,69,6,30,36
416,1,69,27,34,61
417,1,69,8,11,19
418,1,69,21,24,45
419,1,69,32,30,62
420,1,69,75,32,107
421,1,69,41,54,95
422,1,69,19,32,51
423,1,69,1,2,3
424,1,69,0,0,0
