region,day,time,onV,offV,totalV
0,1,0,130,104,234
1,1,0,31,77,108
2,1,0,100,65,165
3,1,0,95,184,279
4,1,0,40,64,104
5,1,0,201,228,429
6,1,0,24,37,61
7,1,0,46,73,119
8,1,0,62,86,148
9,1,0,45,98,143
10,1,0,128,184,312
11,1,0,46,51,97
12,1,0,29,63,92
13,1,0,133,100,233
14,1,0,205,200,405
15,1,0,71,32,103
16,1,0,131,124,255
17,1,0,218,145,363
18,1,0,68,99,167
19,1,0,66,53,119
20,1,0,76,80,156
21,1,0,68,47,115
22,1,0,4,15,19
23,1,0,55,102,157
24,1,0,199,237,436
25,1,0,64,128,192
26,1,0,222,129,351
27,1,0,35,45,80
28,1,0,108,162,270
29,1,0,78,168,246
30,1,0,67,81,148
31,1,0,49,68,117
32,1,0,176,166,342
33,1,0,121,132,253
34,1,0,17,19,36
35,1,0,109,95,204
36,1,0,79,166,245
37,1,0,13,25,38
38,1,0,2,4,6
39,1,0,30,44,74
40,1,0,26,28,54
41,1,0,16,30,46
42,1,0,87,141,228
43,1,0,51,68,119
44,1,0,10,16,26
45,1,0,54,55,109
46,1,0,43,70,113
47,1,0,7,13,20
48,1,0,112,69,181
49,1,0,61,134,195
50,1,0,13,36,49
51,1,0,100,122,222
52,1,0,104,120,224
53,1,0,0,1,1
54,1,0,43,36,79
55,1,0,128,105,233
56,1,0,20,31,51
57,1,0,86,115,201
58,1,0,143,159,302
59,1,0,215,240,455
60,1,0,89,79,168
61,1,0,67,80,147
62,1,0,56,70,126
63,1,0,123,90,213
64,1,0,61,77,138
65,1,0,98,69,167
66,1,0,20,17,37
67,1,0,40,52,92
68,1,0,132,159,291
69,1,0,78,62,140
70,1,0,67,35,102
71,1,0,114,132,246
72,1,0,8,7,15
73,1,0,90,63,153
74,1,0,48,42,90
75,1,0,121,86,207
76,1,0,50,43,93
77,1,0,31,70,101
78,1,0,31,27,58
79,1,0,16,20,36
80,1,0,67,39,106
81,1,0,133,69,202
82,1,0,51,63,114
83,1,0,76,99,175
84,1,0,25,12,37
85,1,0,223,195,418
86,1,0,20,13,33
87,1,0,491,297,788
88,1,0,20,37,57
89,1,0,51,23,74
90,1,0,44,33,77
91,1,0,147,105,252
92,1,0,18,74,92
93,1,0,26,40,66
94,1,0,9,11,20
95,1,0,4,11,15
96,1,0,39,35,74
97,1,0,59,56,115
98,1,0,10,14,24
99,1,0,115,80,195
100,1,0,91,106,197
101,1,0,196,165,361
102,1,0,27,25,52
103,1,0,167,170,337
104,1,0,42,63,105
105,1,0,42,50,92
106,1,0,36,70,106
107,1,0,243,86,329
108,1,0,74,88,162
109,1,0,39,57,96
110,1,0,51,32,83
111,1,0,246,154,400
112,1,0,70,80,150
113,1,0,17,35,52
114,1,0,207,209,416
115,1,0,68,108,176
116,1,0,34,50,84
117,1,0,49,84,133
118,1,0,98,99,197
119,1,0,189,192,381
120,1,0,59,56,115
121,1,0,32,20,52
122,1,0,36,21,57
123,1,0,71,122,193
124,1,0,2,7,9
125,1,0,48,41,89
126,1,0,32,27,59
127,1,0,36,32,68
128,1,0,11,21,32
129,1,0,114,87,201
130,1,0,101,150,251
131,1,0,107,113,220
132,1,0,18,33,51
133,1,0,10,21,31
134,1,0,158,126,284
135,1,0,77,95,172
136,1,0,48,65,113
137,1,0,6,17,23
138,1,0,39,34,73
139,1,0,20,29,49
140,1,0,104,144,248
141,1,0,153,165,318
142,1,0,18,15,33
143,1,0,24,34,58
144,1,0,18,22,40
145,1,0,70,96,166
146,1,0,16,48,64
147,1,0,39,57,96
148,1,0,3,4,7
149,1,0,49,96,145
150,1,0,102,30,132
151,1,0,89,65,154
152,1,0,16,23,39
153,1,0,2,10,12
154,1,0,261,292,553
155,1,0,53,51,104
156,1,0,20,43,63
157,1,0,15,30,45
158,1,0,35,30,65
159,1,0,43,61,104
160,1,0,30,40,70
161,1,0,70,81,151
162,1,0,3,3,6
163,1,0,17,31,48
164,1,0,16,32,48
165,1,0,0,0,0
166,1,0,224,61,285
167,1,0,9,11,20
168,1,0,3,11,14
169,1,0,52,71,123
170,1,0,123,160,283
171,1,0,8,15,23
172,1,0,5,13,18
173,1,0,99,96,195
174,1,0,42,41,83
175,1,0,37,18,55
176,1,0,6,6,12
177,1,0,78,74,152
178,1,0,9,7,16
179,1,0,14,18,32
180,1,0,75,49,124
181,1,0,34,65,99
182,1,0,19,21,40
183,1,0,103,129,232
184,1,0,74,52,126
185,1,0,30,35,65
186,1,0,113,89,202
187,1,0,464,252,716
188,1,0,178,163,341
189,1,0,1,0,1
190,1,0,43,76,119
191,1,0,23,28,51
192,1,0,31,12,43
193,1,0,20,36,56
194,1,0,90,73,163
195,1,0,47,82,129
196,1,0,49,18,67
197,1,0,14,30,44
198,1,0,55,14,69
199,1,0,0,0,0
200,1,0,11,61,72
201,1,0,73,58,131
202,1,0,0,0,0
203,1,0,128,121,249
204,1,0,370,366,736
205,1,0,19,24,43
206,1,0,2,8,10
207,1,0,109,163,272
208,1,0,4,4,8
209,1,0,157,131,288
210,1,0,5,6,11
211,1,0,218,188,406
212,1,0,0,0,0
213,1,0,58,33,91
214,1,0,57,49,106
215,1,0,66,64,130
216,1,0,1,1,2
217,1,0,9,11,20
218,1,0,8,7,15
219,1,0,41,42,83
220,1,0,1,1,2
221,1,0,326,395,721
222,1,0,420,404,824
223,1,0,116,29,145
224,1,0,14,11,25
225,1,0,3,2,5
226,1,0,207,246,453
227,1,0,0,7,7
228,1,0,25,36,61
229,1,0,11,23,34
230,1,0,39,59,98
231,1,0,102,101,203
232,1,0,22,41,63
233,1,0,240,262,502
234,1,0,55,41,96
235,1,0,1,6,7
236,1,0,43,37,80
237,1,0,45,40,85
238,1,0,24,20,44
239,1,0,29,10,39
240,1,0,72,30,102
241,1,0,30,20,50
242,1,0,49,22,71
243,1,0,66,186,252
244,1,0,98,118,216
245,1,0,49,39,88
246,1,0,31,13,44
247,1,0,74,43,117
248,1,0,133,103,236
249,1,0,107,64,171
250,1,0,18,25,43
251,1,0,5,20,25
252,1,0,19,33,52
253,1,0,200,72,272
254,1,0,23,32,55
255,1,0,33,26,59
256,1,0,43,41,84
257,1,0,162,154,316
258,1,0,1,2,3
259,1,0,131,274,405
260,1,0,20,19,39
261,1,0,3,11,14
262,1,0,20,56,76
263,1,0,97,52,149
264,1,0,2,2,4
265,1,0,4,4,8
266,1,0,20,15,35
267,1,0,4,4,8
268,1,0,22,16,38
269,1,0,21,11,32
270,1,0,0,1,1
271,1,0,8,9,17
272,1,0,56,81,137
273,1,0,119,88,207
274,1,0,59,81,140
275,1,0,71,32,103
276,1,0,13,21,34
277,1,0,104,107,211
278,1,0,11,10,21
279,1,0,149,40,189
280,1,0,11,27,38
281,1,0,8,4,12
282,1,0,0,2,2
283,1,0,98,164,262
284,1,0,85,96,181
285,1,0,4,3,7
286,1,0,23,24,47
287,1,0,41,12,53
288,1,0,1,2,3
289,1,0,75,31,106
290,1,0,0,0,0
291,1,0,48,60,108
292,1,0,9,13,22
293,1,0,0,1,1
294,1,0,69,76,145
295,1,0,27,19,46
296,1,0,118,84,202
297,1,0,52,18,70
298,1,0,105,81,186
299,1,0,122,86,208
300,1,0,28,34,62
301,1,0,20,13,33
302,1,0,58,31,89
303,1,0,31,33,64
304,1,0,0,2,2
305,1,0,77,83,160
306,1,0,32,34,66
307,1,0,0,4,4
308,1,0,38,33,71
309,1,0,32,23,55
310,1,0,94,49,143
311,1,0,77,74,151
312,1,0,32,44,76
313,1,0,26,26,52
314,1,0,1,1,2
315,1,0,285,348,633
316,1,0,62,57,119
317,1,0,16,17,33
318,1,0,27,63,90
319,1,0,0,3,3
320,1,0,29,29,58
321,1,0,5,6,11
322,1,0,18,22,40
323,1,0,0,0,0
324,1,0,30,23,53
325,1,0,57,30,87
326,1,0,22,18,40
327,1,0,27,14,41
328,1,0,48,54,102
329,1,0,82,49,131
330,1,0,38,38,76
331,1,0,144,209,353
332,1,0,8,24,32
333,1,0,44,50,94
334,1,0,120,115,235
335,1,0,102,139,241
336,1,0,54,47,101
337,1,0,23,32,55
338,1,0,50,58,108
339,1,0,14,36,50
340,1,0,11,13,24
341,1,0,28,21,49
342,1,0,60,36,96
343,1,0,13,9,22
344,1,0,78,75,153
345,1,0,162,88,250
346,1,0,48,72,120
347,1,0,53,16,69
348,1,0,77,39,116
349,1,0,39,69,108
350,1,0,13,43,56
351,1,0,14,40,54
352,1,0,27,50,77
353,1,0,47,46,93
354,1,0,17,30,47
355,1,0,30,48,78
356,1,0,120,50,170
357,1,0,2,6,8
358,1,0,44,66,110
359,1,0,77,43,120
360,1,0,77,130,207
361,1,0,33,29,62
362,1,0,187,72,259
363,1,0,10,27,37
364,1,0,62,85,147
365,1,0,79,65,144
366,1,0,27,22,49
367,1,0,229,112,341
368,1,0,20,24,44
369,1,0,27,34,61
370,1,0,5,13,18
371,1,0,60,77,137
372,1,0,31,18,49
373,1,0,29,49,78
374,1,0,54,48,102
375,1,0,44,42,86
376,1,0,162,129,291
377,1,0,279,163,442
378,1,0,21,18,39
379,1,0,42,45,87
380,1,0,82,60,142
381,1,0,5,16,21
382,1,0,44,66,110
383,1,0,29,21,50
384,1,0,142,78,220
385,1,0,19,28,47
386,1,0,107,88,195
387,1,0,24,17,41
388,1,0,21,21,42
389,1,0,1,1,2
390,1,0,250,123,373
391,1,0,7,21,28
392,1,0,9,23,32
393,1,0,88,95,183
394,1,0,31,59,90
395,1,0,21,26,47
396,1,0,19,10,29
397,1,0,6,4,10
398,1,0,14,36,50
399,1,0,3,8,11
400,1,0,0,3,3
401,1,0,5,5,10
402,1,0,21,44,65
403,1,0,32,76,108
404,1,0,1,2,3
405,1,0,340,367,707
406,1,0,105,135,240
407,1,0,14,31,45
408,1,0,140,157,297
409,1,0,20,34,54
410,1,0,71,140,211
411,1,0,125,136,261
412,1,0,2,8,10
413,1,0,15,27,42
414,1,0,10,28,38
415,1,0,28,71,99
416,1,0,73,69,142
417,1,0,5,22,27
418,1,0,77,65,142
419,1,0,73,80,153
420,1,0,224,69,293
421,1,0,122,129,251
422,1,0,64,109,173
423,1,0,7,16,23
424,1,0,0,1,1
0,1,3,42,29,71
1,1,3,10,39,49
2,1,3,20,17,37
3,1,3,39,70,109
4,1,3,21,24,45
5,1,3,75,58,133
6,1,3,9,5,14
7,1,3,26,28,54
8,1,3,32,37,69
9,1,3,38,37,75
10,1,3,49,54,103
11,1,3,21,16,37
12,1,3,27,29,56
13,1,3,45,39,84
14,1,3,79,100,179
15,1,3,29,19,48
16,1,3,50,45,95
17,1,3,58,37,95
18,1,3,19,32,51
19,1,3,16,17,33
20,1,3,36,87,123
21,1,3,27,19,46
22,1,3,13,8,21
23,1,3,31,42,73
24,1,3,82,111,193
25,1,3,38,56,94
26,1,3,77,46,123
27,1,3,15,17,32
28,1,3,60,62,122
29,1,3,47,107,154
30,1,3,23,17,40
31,1,3,23,11,34
32,1,3,56,45,101
33,1,3,57,91,148
34,1,3,5,6,11
35,1,3,44,37,81
36,1,3,42,56,98
37,1,3,9,8,17
38,1,3,2,1,3
39,1,3,15,19,34
40,1,3,10,5,15
41,1,3,19,11,30
42,1,3,44,47,91
43,1,3,24,32,56
44,1,3,5,4,9
45,1,3,34,45,79
46,1,3,19,34,53
47,1,3,7,4,11
48,1,3,33,35,68
49,1,3,44,38,82
50,1,3,6,16,22
51,1,3,31,30,61
52,1,3,62,52,114
53,1,3,0,0,0
54,1,3,24,25,49
55,1,3,51,90,141
56,1,3,6,10,16
57,1,3,45,75,120
58,1,3,52,75,127
59,1,3,92,172,264
60,1,3,45,44,89
61,1,3,32,30,62
62,1,3,27,51,78
63,1,3,64,53,117
64,1,3,47,54,101
65,1,3,29,24,53
66,1,3,16,5,21
67,1,3,24,11,35
68,1,3,47,45,92
69,1,3,21,28,49
70,1,3,32,13,45
71,1,3,47,56,103
72,1,3,2,5,7
73,1,3,20,28,48
74,1,3,13,12,25
75,1,3,67,79,146
76,1,3,18,13,31
77,1,3,18,29,47
78,1,3,18,11,29
79,1,3,11,10,21
80,1,3,30,27,57
81,1,3,31,13,44
82,1,3,23,17,40
83,1,3,44,69,113
84,1,3,15,6,21
85,1,3,210,59,269
86,1,3,15,3,18
87,1,3,286,130,416
88,1,3,12,17,29
89,1,3,16,3,19
90,1,3,16,15,31
91,1,3,48,36,84
92,1,3,12,14,26
93,1,3,11,21,32
94,1,3,6,2,8
95,1,3,3,4,7
96,1,3,20,16,36
97,1,3,25,10,35
98,1,3,6,0,6
99,1,3,43,39,82
100,1,3,31,33,64
101,1,3,66,61,127
102,1,3,13,11,24
103,1,3,95,100,195
104,1,3,16,30,46
105,1,3,14,13,27
106,1,3,2,8,10
107,1,3,77,15,92
108,1,3,39,31,70
109,1,3,32,23,55
110,1,3,19,10,29
111,1,3,96,55,151
112,1,3,39,49,88
113,1,3,14,20,34
114,1,3,111,82,193
115,1,3,53,72,125
116,1,3,8,13,21
117,1,3,31,40,71
118,1,3,20,27,47
119,1,3,82,75,157
120,1,3,25,16,41
121,1,3,19,11,30
122,1,3,21,6,27
123,1,3,47,57,104
124,1,3,0,1,1
125,1,3,32,10,42
126,1,3,20,8,28
127,1,3,10,9,19
128,1,3,3,3,6
129,1,3,26,27,53
130,1,3,50,71,121
131,1,3,64,43,107
132,1,3,7,10,17
133,1,3,4,3,7
134,1,3,63,58,121
135,1,3,53,67,120
136,1,3,13,16,29
137,1,3,2,2,4
138,1,3,22,22,44
139,1,3,4,3,7
140,1,3,57,55,112
141,1,3,83,52,135
142,1,3,15,7,22
143,1,3,9,7,16
144,1,3,13,3,16
145,1,3,32,66,98
146,1,3,10,23,33
147,1,3,15,29,44
148,1,3,0,3,3
149,1,3,19,38,57
150,1,3,4,0,4
151,1,3,32,32,64
152,1,3,14,10,24
153,1,3,4,7,11
154,1,3,110,208,318
155,1,3,23,24,47
156,1,3,16,20,36
157,1,3,8,7,15
158,1,3,12,3,15
159,1,3,53,60,113
160,1,3,8,15,23
161,1,3,59,37,96
162,1,3,3,1,4
163,1,3,7,8,15
164,1,3,7,6,13
165,1,3,1,6,7
166,1,3,26,13,39
167,1,3,2,2,4
168,1,3,4,14,18
169,1,3,31,28,59
170,1,3,65,54,119
171,1,3,1,3,4
172,1,3,4,9,13
173,1,3,39,33,72
174,1,3,8,12,20
175,1,3,17,13,30
176,1,3,3,4,7
177,1,3,38,41,79
178,1,3,10,3,13
179,1,3,2,6,8
180,1,3,34,15,49
181,1,3,27,19,46
182,1,3,5,7,12
183,1,3,54,48,102
184,1,3,18,13,31
185,1,3,17,31,48
186,1,3,57,32,89
187,1,3,194,84,278
188,1,3,53,58,111
189,1,3,0,0,0
190,1,3,26,45,71
191,1,3,4,10,14
192,1,3,3,3,6
193,1,3,2,5,7
194,1,3,28,30,58
195,1,3,15,17,32
196,1,3,3,3,6
197,1,3,21,30,51
198,1,3,31,9,40
199,1,3,0,0,0
200,1,3,9,11,20
201,1,3,58,20,78
202,1,3,0,0,0
203,1,3,61,35,96
204,1,3,180,176,356
205,1,3,12,25,37
206,1,3,0,0,0
207,1,3,50,68,118
208,1,3,0,2,2
209,1,3,46,31,77
210,1,3,8,8,16
211,1,3,115,110,225
212,1,3,0,0,0
213,1,3,7,6,13
214,1,3,38,15,53
215,1,3,20,27,47
216,1,3,1,1,2
217,1,3,1,0,1
218,1,3,5,2,7
219,1,3,20,14,34
220,1,3,0,0,0
221,1,3,156,157,313
222,1,3,159,142,301
223,1,3,11,5,16
224,1,3,6,2,8
225,1,3,0,0,0
226,1,3,90,118,208
227,1,3,0,1,1
228,1,3,23,11,34
229,1,3,5,8,13
230,1,3,21,24,45
231,1,3,47,40,87
232,1,3,11,15,26
233,1,3,127,113,240
234,1,3,26,24,50
235,1,3,0,0,0
236,1,3,18,23,41
237,1,3,10,10,20
238,1,3,2,3,5
239,1,3,5,5,10
240,1,3,13,9,22
241,1,3,7,2,9
242,1,3,23,10,33
243,1,3,49,69,118
244,1,3,52,44,96
245,1,3,25,16,41
246,1,3,4,5,9
247,1,3,41,18,59
248,1,3,52,37,89
249,1,3,39,32,71
250,1,3,14,10,24
251,1,3,6,8,14
252,1,3,8,4,12
253,1,3,86,26,112
254,1,3,9,15,24
255,1,3,9,6,15
256,1,3,22,13,35
257,1,3,126,205,331
258,1,3,0,0,0
259,1,3,152,297,449
260,1,3,10,6,16
261,1,3,3,4,7
262,1,3,10,6,16
263,1,3,13,8,21
264,1,3,0,2,2
265,1,3,1,2,3
266,1,3,8,12,20
267,1,3,0,0,0
268,1,3,16,12,28
269,1,3,6,10,16
270,1,3,0,0,0
271,1,3,0,0,0
272,1,3,48,70,118
273,1,3,65,93,158
274,1,3,45,37,82
275,1,3,23,30,53
276,1,3,7,2,9
277,1,3,31,44,75
278,1,3,3,2,5
279,1,3,39,30,69
280,1,3,7,13,20
281,1,3,1,3,4
282,1,3,0,2,2
283,1,3,39,71,110
284,1,3,49,53,102
285,1,3,0,0,0
286,1,3,9,6,15
287,1,3,5,1,6
288,1,3,0,0,0
289,1,3,12,16,28
290,1,3,0,1,1
291,1,3,20,20,40
292,1,3,23,13,36
293,1,3,0,1,1
294,1,3,42,26,68
295,1,3,10,5,15
296,1,3,69,47,116
297,1,3,19,8,27
298,1,3,35,26,61
299,1,3,40,21,61
300,1,3,20,14,34
301,1,3,11,9,20
302,1,3,16,15,31
303,1,3,11,7,18
304,1,3,0,0,0
305,1,3,72,23,95
306,1,3,10,9,19
307,1,3,0,0,0
308,1,3,9,15,24
309,1,3,12,5,17
310,1,3,48,12,60
311,1,3,27,21,48
312,1,3,20,16,36
313,1,3,8,6,14
314,1,3,0,0,0
315,1,3,102,94,196
316,1,3,14,39,53
317,1,3,6,4,10
318,1,3,26,40,66
319,1,3,3,1,4
320,1,3,14,9,23
321,1,3,3,4,7
322,1,3,18,12,30
323,1,3,0,2,2
324,1,3,6,3,9
325,1,3,27,22,49
326,1,3,8,6,14
327,1,3,7,14,21
328,1,3,59,146,205
329,1,3,18,17,35
330,1,3,18,13,31
331,1,3,166,290,456
332,1,3,6,6,12
333,1,3,55,232,287
334,1,3,52,69,121
335,1,3,60,72,132
336,1,3,42,29,71
337,1,3,4,10,14
338,1,3,37,25,62
339,1,3,18,13,31
340,1,3,6,4,10
341,1,3,12,7,19
342,1,3,24,18,42
343,1,3,4,7,11
344,1,3,40,49,89
345,1,3,46,28,74
346,1,3,29,36,65
347,1,3,25,9,34
348,1,3,35,15,50
349,1,3,48,95,143
350,1,3,15,16,31
351,1,3,17,7,24
352,1,3,20,27,47
353,1,3,40,32,72
354,1,3,14,22,36
355,1,3,16,13,29
356,1,3,34,9,43
357,1,3,2,0,2
358,1,3,29,16,45
359,1,3,24,8,32
360,1,3,47,36,83
361,1,3,9,6,15
362,1,3,40,14,54
363,1,3,15,8,23
364,1,3,52,29,81
365,1,3,50,42,92
366,1,3,12,12,24
367,1,3,92,32,124
368,1,3,12,7,19
369,1,3,13,20,33
370,1,3,1,8,9
371,1,3,56,32,88
372,1,3,17,10,27
373,1,3,15,14,29
374,1,3,29,26,55
375,1,3,14,17,31
376,1,3,138,49,187
377,1,3,248,80,328
378,1,3,9,7,16
379,1,3,30,8,38
380,1,3,14,9,23
381,1,3,1,4,5
382,1,3,42,202,244
383,1,3,25,44,69
384,1,3,43,29,72
385,1,3,13,7,20
386,1,3,36,27,63
387,1,3,5,11,16
388,1,3,10,11,21
389,1,3,0,0,0
390,1,3,90,362,452
391,1,3,6,12,18
392,1,3,10,9,19
393,1,3,31,27,58
394,1,3,11,14,25
395,1,3,2,5,7
396,1,3,4,1,5
397,1,3,1,2,3
398,1,3,8,11,19
399,1,3,4,4,8
400,1,3,0,1,1
401,1,3,1,1,2
402,1,3,6,8,14
403,1,3,18,28,46
404,1,3,0,1,1
405,1,3,148,137,285
406,1,3,63,57,120
407,1,3,5,14,19
408,1,3,111,132,243
409,1,3,10,13,23
410,1,3,49,67,116
411,1,3,106,95,201
412,1,3,0,4,4
413,1,3,5,5,10
414,1,3,7,10,17
415,1,3,16,26,42
416,1,3,21,18,39
417,1,3,9,5,14
418,1,3,25,22,47
419,1,3,65,25,90
420,1,3,62,22,84
421,1,3,59,43,102
422,1,3,44,55,99
423,1,3,10,13,23
424,1,3,0,0,0
0,1,6,84,62,146
1,1,6,46,35,81
2,1,6,97,123,220
3,1,6,99,59,158
4,1,6,96,50,146
5,1,6,99,78,177
6,1,6,31,14,45
7,1,6,67,40,107
8,1,6,84,48,132
9,1,6,125,49,174
10,1,6,110,56,166
11,1,6,81,46,127
12,1,6,46,18,64
13,1,6,133,76,209
14,1,6,76,60,136
15,1,6,63,168,231
16,1,6,202,154,356
17,1,6,55,61,116
18,1,6,80,58,138
19,1,6,51,21,72
20,1,6,71,49,120
21,1,6,66,99,165
22,1,6,31,17,48
23,1,6,113,59,172
24,1,6,196,100,296
25,1,6,57,36,93
26,1,6,77,111,188
27,1,6,117,70,187
28,1,6,137,79,216
29,1,6,94,38,132
30,1,6,85,51,136
31,1,6,120,48,168
32,1,6,192,147,339
33,1,6,266,395,661
34,1,6,44,51,95
35,1,6,51,31,82
36,1,6,102,88,190
37,1,6,31,18,49
38,1,6,8,25,33
39,1,6,95,165,260
40,1,6,34,24,58
41,1,6,60,55,115
42,1,6,169,83,252
43,1,6,98,65,163
44,1,6,21,24,45
45,1,6,72,50,122
46,1,6,71,73,144
47,1,6,13,17,30
48,1,6,84,67,151
49,1,6,99,67,166
50,1,6,30,73,103
51,1,6,141,54,195
52,1,6,111,67,178
53,1,6,1,0,1
54,1,6,23,22,45
55,1,6,130,132,262
56,1,6,40,22,62
57,1,6,142,125,267
58,1,6,115,130,245
59,1,6,363,596,959
60,1,6,103,79,182
61,1,6,66,80,146
62,1,6,162,163,325
63,1,6,74,56,130
64,1,6,85,133,218
65,1,6,48,31,79
66,1,6,23,20,43
67,1,6,71,43,114
68,1,6,136,77,213
69,1,6,56,203,259
70,1,6,64,86,150
71,1,6,124,96,220
72,1,6,7,22,29
73,1,6,88,95,183
74,1,6,50,40,90
75,1,6,60,41,101
76,1,6,33,38,71
77,1,6,67,71,138
78,1,6,48,43,91
79,1,6,32,10,42
80,1,6,56,34,90
81,1,6,25,27,52
82,1,6,74,36,110
83,1,6,67,74,141
84,1,6,12,16,28
85,1,6,39,55,94
86,1,6,26,32,58
87,1,6,77,75,152
88,1,6,17,27,44
89,1,6,43,45,88
90,1,6,58,100,158
91,1,6,153,181,334
92,1,6,32,24,56
93,1,6,73,76,149
94,1,6,22,15,37
95,1,6,6,10,16
96,1,6,111,120,231
97,1,6,63,81,144
98,1,6,27,7,34
99,1,6,89,95,184
100,1,6,93,57,150
101,1,6,106,72,178
102,1,6,32,105,137
103,1,6,150,149,299
104,1,6,46,62,108
105,1,6,46,42,88
106,1,6,27,21,48
107,1,6,81,63,144
108,1,6,168,70,238
109,1,6,52,30,82
110,1,6,48,100,148
111,1,6,149,90,239
112,1,6,95,48,143
113,1,6,62,65,127
114,1,6,89,46,135
115,1,6,85,87,172
116,1,6,50,37,87
117,1,6,92,30,122
118,1,6,46,40,86
119,1,6,117,63,180
120,1,6,56,17,73
121,1,6,95,90,185
122,1,6,35,27,62
123,1,6,141,109,250
124,1,6,2,1,3
125,1,6,42,17,59
126,1,6,57,24,81
127,1,6,67,67,134
128,1,6,13,20,33
129,1,6,61,40,101
130,1,6,111,69,180
131,1,6,224,118,342
132,1,6,94,64,158
133,1,6,34,45,79
134,1,6,113,69,182
135,1,6,131,45,176
136,1,6,49,75,124
137,1,6,12,11,23
138,1,6,59,51,110
139,1,6,39,54,93
140,1,6,99,107,206
141,1,6,211,82,293
142,1,6,82,130,212
143,1,6,32,40,72
144,1,6,19,18,37
145,1,6,101,89,190
146,1,6,31,95,126
147,1,6,32,32,64
148,1,6,5,11,16
149,1,6,94,64,158
150,1,6,1,7,8
151,1,6,71,38,109
152,1,6,41,41,82
153,1,6,8,21,29
154,1,6,189,152,341
155,1,6,135,254,389
156,1,6,58,41,99
157,1,6,42,29,71
158,1,6,27,35,62
159,1,6,85,71,156
160,1,6,31,34,65
161,1,6,92,70,162
162,1,6,8,11,19
163,1,6,32,28,60
164,1,6,23,52,75
165,1,6,15,73,88
166,1,6,99,98,197
167,1,6,17,30,47
168,1,6,42,187,229
169,1,6,79,67,146
170,1,6,249,212,461
171,1,6,16,30,46
172,1,6,21,25,46
173,1,6,189,171,360
174,1,6,53,28,81
175,1,6,49,70,119
176,1,6,17,19,36
177,1,6,142,85,227
178,1,6,29,41,70
179,1,6,28,43,71
180,1,6,52,35,87
181,1,6,131,105,236
182,1,6,40,128,168
183,1,6,111,55,166
184,1,6,85,257,342
185,1,6,53,40,93
186,1,6,124,272,396
187,1,6,101,55,156
188,1,6,257,129,386
189,1,6,1,1,2
190,1,6,45,38,83
191,1,6,79,149,228
192,1,6,36,45,81
193,1,6,65,62,127
194,1,6,71,55,126
195,1,6,169,100,269
196,1,6,22,17,39
197,1,6,51,31,82
198,1,6,43,32,75
199,1,6,0,1,1
200,1,6,62,27,89
201,1,6,204,89,293
202,1,6,0,1,1
203,1,6,151,141,292
204,1,6,196,214,410
205,1,6,32,62,94
206,1,6,1,12,13
207,1,6,86,51,137
208,1,6,2,0,2
209,1,6,263,230,493
210,1,6,9,15,24
211,1,6,126,74,200
212,1,6,2,1,3
213,1,6,58,55,113
214,1,6,69,31,100
215,1,6,250,420,670
216,1,6,8,23,31
217,1,6,13,22,35
218,1,6,28,32,60
219,1,6,77,73,150
220,1,6,1,5,6
221,1,6,200,108,308
222,1,6,309,221,530
223,1,6,31,22,53
224,1,6,7,18,25
225,1,6,0,5,5
226,1,6,262,301,563
227,1,6,0,1,1
228,1,6,54,42,96
229,1,6,22,14,36
230,1,6,77,29,106
231,1,6,96,36,132
232,1,6,57,71,128
233,1,6,188,112,300
234,1,6,62,57,119
235,1,6,5,5,10
236,1,6,111,137,248
237,1,6,48,69,117
238,1,6,33,44,77
239,1,6,19,18,37
240,1,6,54,50,104
241,1,6,42,30,72
242,1,6,87,49,136
243,1,6,224,110,334
244,1,6,128,64,192
245,1,6,80,40,120
246,1,6,14,19,33
247,1,6,59,64,123
248,1,6,120,78,198
249,1,6,115,147,262
250,1,6,42,32,74
251,1,6,47,36,83
252,1,6,39,24,63
253,1,6,32,22,54
254,1,6,73,35,108
255,1,6,61,53,114
256,1,6,86,61,147
257,1,6,371,576,947
258,1,6,0,0,0
259,1,6,715,1682,2397
260,1,6,31,18,49
261,1,6,39,36,75
262,1,6,58,24,82
263,1,6,51,49,100
264,1,6,1,1,2
265,1,6,4,2,6
266,1,6,50,75,125
267,1,6,0,2,2
268,1,6,7,71,78
269,1,6,25,29,54
270,1,6,0,1,1
271,1,6,7,6,13
272,1,6,153,337,490
273,1,6,128,130,258
274,1,6,92,37,129
275,1,6,50,42,92
276,1,6,20,16,36
277,1,6,160,59,219
278,1,6,7,13,20
279,1,6,160,255,415
280,1,6,21,9,30
281,1,6,13,14,27
282,1,6,0,2,2
283,1,6,150,50,200
284,1,6,54,36,90
285,1,6,2,2,4
286,1,6,27,86,113
287,1,6,23,25,48
288,1,6,2,8,10
289,1,6,88,85,173
290,1,6,0,1,1
291,1,6,52,27,79
292,1,6,40,37,77
293,1,6,2,2,4
294,1,6,143,101,244
295,1,6,38,35,73
296,1,6,102,149,251
297,1,6,32,38,70
298,1,6,125,52,177
299,1,6,59,46,105
300,1,6,68,32,100
301,1,6,37,60,97
302,1,6,37,22,59
303,1,6,30,22,52
304,1,6,2,4,6
305,1,6,17,10,27
306,1,6,45,27,72
307,1,6,0,2,2
308,1,6,57,25,82
309,1,6,79,52,131
310,1,6,47,32,79
311,1,6,53,42,95
312,1,6,45,30,75
313,1,6,41,92,133
314,1,6,2,7,9
315,1,6,225,108,333
316,1,6,119,392,511
317,1,6,25,92,117
318,1,6,89,76,165
319,1,6,2,2,4
320,1,6,91,150,241
321,1,6,8,10,18
322,1,6,35,21,56
323,1,6,1,6,7
324,1,6,29,112,141
325,1,6,119,218,337
326,1,6,21,22,43
327,1,6,65,126,191
328,1,6,118,162,280
329,1,6,38,48,86
330,1,6,90,45,135
331,1,6,677,1565,2242
332,1,6,43,25,68
333,1,6,107,253,360
334,1,6,238,132,370
335,1,6,195,144,339
336,1,6,101,59,160
337,1,6,77,48,125
338,1,6,98,83,181
339,1,6,68,39,107
340,1,6,33,13,46
341,1,6,38,33,71
342,1,6,48,29,77
343,1,6,24,22,46
344,1,6,179,402,581
345,1,6,144,130,274
346,1,6,123,95,218
347,1,6,47,60,107
348,1,6,66,77,143
349,1,6,112,144,256
350,1,6,103,33,136
351,1,6,88,66,154
352,1,6,72,41,113
353,1,6,92,190,282
354,1,6,60,33,93
355,1,6,53,48,101
356,1,6,127,100,227
357,1,6,7,34,41
358,1,6,80,39,119
359,1,6,67,48,115
360,1,6,219,93,312
361,1,6,55,35,90
362,1,6,154,142,296
363,1,6,64,44,108
364,1,6,155,74,229
365,1,6,91,71,162
366,1,6,83,37,120
367,1,6,143,81,224
368,1,6,30,35,65
369,1,6,85,23,108
370,1,6,22,25,47
371,1,6,152,76,228
372,1,6,54,109,163
373,1,6,46,21,67
374,1,6,109,143,252
375,1,6,68,29,97
376,1,6,85,60,145
377,1,6,69,59,128
378,1,6,39,33,72
379,1,6,99,51,150
380,1,6,77,63,140
381,1,6,22,20,42
382,1,6,147,186,333
383,1,6,74,57,131
384,1,6,105,58,163
385,1,6,44,33,77
386,1,6,96,37,133
387,1,6,37,33,70
388,1,6,103,137,240
389,1,6,1,0,1
390,1,6,274,809,1083
391,1,6,33,23,56
392,1,6,51,61,112
393,1,6,175,145,320
394,1,6,76,62,138
395,1,6,94,107,201
396,1,6,45,70,115
397,1,6,26,19,45
398,1,6,91,72,163
399,1,6,23,25,48
400,1,6,31,39,70
401,1,6,17,33,50
402,1,6,45,40,85
403,1,6,109,95,204
404,1,6,0,17,17
405,1,6,417,422,839
406,1,6,141,136,277
407,1,6,9,3,12
408,1,6,216,144,360
409,1,6,21,19,40
410,1,6,127,65,192
411,1,6,219,127,346
412,1,6,4,6,10
413,1,6,7,8,15
414,1,6,15,24,39
415,1,6,46,60,106
416,1,6,112,55,167
417,1,6,8,10,18
418,1,6,87,83,170
419,1,6,32,42,74
420,1,6,28,50,78
421,1,6,156,107,263
422,1,6,243,261,504
423,1,6,2,5,7
424,1,6,0,0,0
0,1,9,155,231,386
1,1,9,42,45,87
2,1,9,153,143,296
3,1,9,94,67,161
4,1,9,87,83,170
5,1,9,107,104,211
6,1,9,49,60,109
7,1,9,94,93,187
8,1,9,115,88,203
9,1,9,71,66,137
10,1,9,138,94,232
11,1,9,52,34,86
12,1,9,48,29,77
13,1,9,154,107,261
14,1,9,57,50,107
15,1,9,197,212,409
16,1,9,204,230,434
17,1,9,92,87,179
18,1,9,109,74,183
19,1,9,82,56,138
20,1,9,40,40,80
21,1,9,219,187,406
22,1,9,25,43,68
23,1,9,160,119,279
24,1,9,129,74,203
25,1,9,56,58,114
26,1,9,145,177,322
27,1,9,74,60,134
28,1,9,125,92,217
29,1,9,85,79,164
30,1,9,82,75,157
31,1,9,88,52,140
32,1,9,263,267,530
33,1,9,547,546,1093
34,1,9,53,50,103
35,1,9,86,78,164
36,1,9,142,91,233
37,1,9,20,20,40
38,1,9,27,38,65
39,1,9,128,185,313
40,1,9,38,38,76
41,1,9,49,60,109
42,1,9,114,89,203
43,1,9,62,67,129
44,1,9,27,34,61
45,1,9,62,37,99
46,1,9,119,82,201
47,1,9,26,27,53
48,1,9,107,91,198
49,1,9,177,132,309
50,1,9,49,73,122
51,1,9,102,69,171
52,1,9,113,101,214
53,1,9,0,0,0
54,1,9,26,28,54
55,1,9,216,260,476
56,1,9,21,22,43
57,1,9,122,140,262
58,1,9,135,151,286
59,1,9,460,478,938
60,1,9,96,57,153
61,1,9,97,106,203
62,1,9,118,125,243
63,1,9,91,95,186
64,1,9,192,189,381
65,1,9,40,41,81
66,1,9,26,24,50
67,1,9,119,46,165
68,1,9,144,120,264
69,1,9,135,380,515
70,1,9,107,90,197
71,1,9,183,210,393
72,1,9,15,40,55
73,1,9,127,141,268
74,1,9,60,52,112
75,1,9,60,53,113
76,1,9,56,79,135
77,1,9,114,106,220
78,1,9,73,54,127
79,1,9,43,30,73
80,1,9,55,53,108
81,1,9,37,40,77
82,1,9,69,49,118
83,1,9,99,134,233
84,1,9,43,35,78
85,1,9,60,89,149
86,1,9,40,31,71
87,1,9,103,109,212
88,1,9,31,55,86
89,1,9,57,52,109
90,1,9,156,165,321
91,1,9,237,187,424
92,1,9,40,58,98
93,1,9,75,86,161
94,1,9,41,27,68
95,1,9,9,22,31
96,1,9,145,197,342
97,1,9,93,92,185
98,1,9,56,33,89
99,1,9,127,109,236
100,1,9,84,76,160
101,1,9,102,92,194
102,1,9,83,122,205
103,1,9,185,340,525
104,1,9,77,112,189
105,1,9,88,65,153
106,1,9,48,53,101
107,1,9,93,76,169
108,1,9,110,80,190
109,1,9,47,62,109
110,1,9,102,116,218
111,1,9,144,111,255
112,1,9,65,62,127
113,1,9,59,81,140
114,1,9,55,46,101
115,1,9,139,164,303
116,1,9,78,53,131
117,1,9,60,53,113
118,1,9,32,26,58
119,1,9,93,71,164
120,1,9,40,34,74
121,1,9,125,115,240
122,1,9,45,37,82
123,1,9,200,191,391
124,1,9,1,4,5
125,1,9,54,35,89
126,1,9,73,40,113
127,1,9,63,64,127
128,1,9,24,26,50
129,1,9,86,82,168
130,1,9,99,85,184
131,1,9,148,110,258
132,1,9,90,82,172
133,1,9,42,83,125
134,1,9,97,66,163
135,1,9,118,91,209
136,1,9,64,72,136
137,1,9,14,9,23
138,1,9,77,85,162
139,1,9,28,43,71
140,1,9,178,180,358
141,1,9,286,207,493
142,1,9,140,124,264
143,1,9,66,97,163
144,1,9,37,28,65
145,1,9,98,109,207
146,1,9,62,133,195
147,1,9,18,28,46
148,1,9,22,29,51
149,1,9,92,82,174
150,1,9,2,15,17
151,1,9,56,41,97
152,1,9,107,129,236
153,1,9,29,54,83
154,1,9,163,185,348
155,1,9,272,289,561
156,1,9,66,90,156
157,1,9,54,52,106
158,1,9,41,38,79
159,1,9,65,83,148
160,1,9,25,33,58
161,1,9,115,92,207
162,1,9,12,22,34
163,1,9,58,38,96
164,1,9,37,53,90
165,1,9,88,158,246
166,1,9,156,174,330
167,1,9,21,38,59
168,1,9,184,276,460
169,1,9,36,31,67
170,1,9,304,239,543
171,1,9,68,75,143
172,1,9,40,40,80
173,1,9,279,229,508
174,1,9,55,77,132
175,1,9,68,78,146
176,1,9,36,31,67
177,1,9,96,57,153
178,1,9,64,115,179
179,1,9,28,51,79
180,1,9,48,36,84
181,1,9,173,163,336
182,1,9,149,107,256
183,1,9,95,83,178
184,1,9,186,404,590
185,1,9,65,44,109
186,1,9,253,273,526
187,1,9,137,147,284
188,1,9,126,109,235
189,1,9,3,8,11
190,1,9,40,61,101
191,1,9,99,119,218
192,1,9,54,43,97
193,1,9,76,77,153
194,1,9,92,65,157
195,1,9,185,133,318
196,1,9,46,43,89
197,1,9,26,44,70
198,1,9,52,31,83
199,1,9,1,1,2
200,1,9,50,43,93
201,1,9,250,121,371
202,1,9,1,3,4
203,1,9,201,186,387
204,1,9,224,253,477
205,1,9,33,40,73
206,1,9,12,21,33
207,1,9,100,92,192
208,1,9,0,7,7
209,1,9,447,388,835
210,1,9,17,20,37
211,1,9,101,84,185
212,1,9,0,1,1
213,1,9,91,100,191
214,1,9,90,39,129
215,1,9,428,409,837
216,1,9,4,17,21
217,1,9,29,24,53
218,1,9,68,95,163
219,1,9,89,105,194
220,1,9,24,44,68
221,1,9,144,140,284
222,1,9,232,236,468
223,1,9,86,76,162
224,1,9,17,18,35
225,1,9,4,20,24
226,1,9,291,287,578
227,1,9,1,3,4
228,1,9,74,53,127
229,1,9,14,36,50
230,1,9,83,55,138
231,1,9,134,77,211
232,1,9,71,41,112
233,1,9,155,127,282
234,1,9,77,61,138
235,1,9,5,3,8
236,1,9,153,123,276
237,1,9,100,156,256
238,1,9,66,58,124
239,1,9,30,24,54
240,1,9,100,107,207
241,1,9,53,85,138
242,1,9,93,97,190
243,1,9,102,101,203
244,1,9,108,71,179
245,1,9,105,73,178
246,1,9,22,29,51
247,1,9,88,89,177
248,1,9,161,118,279
249,1,9,206,146,352
250,1,9,64,50,114
251,1,9,58,76,134
252,1,9,44,41,85
253,1,9,60,35,95
254,1,9,89,79,168
255,1,9,69,85,154
256,1,9,137,80,217
257,1,9,485,588,1073
258,1,9,0,3,3
259,1,9,1052,1158,2210
260,1,9,53,42,95
261,1,9,291,291,582
262,1,9,42,44,86
263,1,9,70,67,137
264,1,9,2,6,8
265,1,9,7,8,15
266,1,9,74,90,164
267,1,9,6,4,10
268,1,9,25,45,70
269,1,9,67,122,189
270,1,9,0,2,2
271,1,9,6,13,19
272,1,9,216,519,735
273,1,9,217,166,383
274,1,9,78,49,127
275,1,9,64,40,104
276,1,9,14,40,54
277,1,9,125,102,227
278,1,9,21,21,42
279,1,9,149,159,308
280,1,9,9,7,16
281,1,9,23,38,61
282,1,9,2,1,3
283,1,9,380,101,481
284,1,9,64,63,127
285,1,9,0,10,10
286,1,9,66,90,156
287,1,9,61,80,141
288,1,9,9,8,17
289,1,9,197,177,374
290,1,9,1,0,1
291,1,9,49,38,87
292,1,9,35,43,78
293,1,9,0,1,1
294,1,9,128,73,201
295,1,9,35,41,76
296,1,9,180,219,399
297,1,9,92,133,225
298,1,9,59,53,112
299,1,9,168,175,343
300,1,9,72,31,103
301,1,9,59,63,122
302,1,9,51,45,96
303,1,9,42,25,67
304,1,9,2,2,4
305,1,9,5,29,34
306,1,9,52,46,98
307,1,9,1,11,12
308,1,9,53,36,89
309,1,9,149,174,323
310,1,9,115,90,205
311,1,9,36,38,74
312,1,9,52,45,97
313,1,9,97,125,222
314,1,9,3,8,11
315,1,9,239,194,433
316,1,9,226,243,469
317,1,9,54,79,133
318,1,9,117,133,250
319,1,9,4,7,11
320,1,9,128,114,242
321,1,9,6,10,16
322,1,9,53,40,93
323,1,9,2,6,8
324,1,9,83,152,235
325,1,9,257,185,442
326,1,9,32,34,66
327,1,9,129,102,231
328,1,9,192,293,485
329,1,9,37,55,92
330,1,9,93,70,163
331,1,9,1031,1162,2193
332,1,9,30,17,47
333,1,9,141,232,373
334,1,9,190,192,382
335,1,9,172,157,329
336,1,9,148,92,240
337,1,9,54,33,87
338,1,9,96,66,162
339,1,9,40,33,73
340,1,9,9,20,29
341,1,9,42,34,76
342,1,9,58,67,125
343,1,9,32,46,78
344,1,9,337,331,668
345,1,9,198,168,366
346,1,9,121,96,217
347,1,9,95,70,165
348,1,9,68,82,150
349,1,9,183,264,447
350,1,9,72,52,124
351,1,9,65,55,120
352,1,9,47,44,91
353,1,9,183,176,359
354,1,9,29,29,58
355,1,9,72,57,129
356,1,9,167,165,332
357,1,9,8,25,33
358,1,9,69,41,110
359,1,9,78,85,163
360,1,9,122,84,206
361,1,9,52,36,88
362,1,9,192,138,330
363,1,9,58,40,98
364,1,9,134,75,209
365,1,9,104,128,232
366,1,9,123,55,178
367,1,9,103,76,179
368,1,9,24,29,53
369,1,9,65,43,108
370,1,9,18,17,35
371,1,9,126,85,211
372,1,9,108,107,215
373,1,9,40,32,72
374,1,9,143,145,288
375,1,9,47,41,88
376,1,9,121,123,244
377,1,9,115,111,226
378,1,9,54,67,121
379,1,9,102,54,156
380,1,9,70,57,127
381,1,9,14,24,38
382,1,9,168,199,367
383,1,9,70,126,196
384,1,9,111,86,197
385,1,9,32,34,66
386,1,9,72,47,119
387,1,9,38,33,71
388,1,9,136,135,271
389,1,9,0,1,1
390,1,9,673,857,1530
391,1,9,42,27,69
392,1,9,36,55,91
393,1,9,226,231,457
394,1,9,146,123,269
395,1,9,188,207,395
396,1,9,86,71,157
397,1,9,48,31,79
398,1,9,87,116,203
399,1,9,54,37,91
400,1,9,43,45,88
401,1,9,47,45,92
402,1,9,43,63,106
403,1,9,156,110,266
404,1,9,8,22,30
405,1,9,469,524,993
406,1,9,189,174,363
407,1,9,8,20,28
408,1,9,157,145,302
409,1,9,27,44,71
410,1,9,50,62,112
411,1,9,130,90,220
412,1,9,2,8,10
413,1,9,13,31,44
414,1,9,18,29,47
415,1,9,57,67,124
416,1,9,102,67,169
417,1,9,18,27,45
418,1,9,94,89,183
419,1,9,78,71,149
420,1,9,91,154,245
421,1,9,172,129,301
422,1,9,333,357,690
423,1,9,4,18,22
424,1,9,7,9,16
0,1,12,245,255,500
1,1,12,68,43,111
2,1,12,188,167,355
3,1,12,96,108,204
4,1,12,98,96,194
5,1,12,165,170,335
6,1,12,59,64,123
7,1,12,102,102,204
8,1,12,123,106,229
9,1,12,84,81,165
10,1,12,162,135,297
11,1,12,48,36,84
12,1,12,82,52,134
13,1,12,137,118,255
14,1,12,75,90,165
15,1,12,205,221,426
16,1,12,193,201,394
17,1,12,129,104,233
18,1,12,105,90,195
19,1,12,64,44,108
20,1,12,54,46,100
21,1,12,223,184,407
22,1,12,35,51,86
23,1,12,113,121,234
24,1,12,132,108,240
25,1,12,71,62,133
26,1,12,203,195,398
27,1,12,68,75,143
28,1,12,164,109,273
29,1,12,137,110,247
30,1,12,90,79,169
31,1,12,90,83,173
32,1,12,268,253,521
33,1,12,598,663,1261
34,1,12,58,59,117
35,1,12,103,114,217
36,1,12,149,126,275
37,1,12,33,25,58
38,1,12,25,46,71
39,1,12,149,191,340
40,1,12,57,46,103
41,1,12,60,78,138
42,1,12,118,111,229
43,1,12,81,113,194
44,1,12,26,35,61
45,1,12,60,51,111
46,1,12,83,96,179
47,1,12,17,31,48
48,1,12,107,104,211
49,1,12,112,104,216
50,1,12,26,60,86
51,1,12,84,90,174
52,1,12,134,152,286
53,1,12,0,0,0
54,1,12,48,31,79
55,1,12,323,299,622
56,1,12,24,33,57
57,1,12,160,174,334
58,1,12,155,153,308
59,1,12,557,547,1104
60,1,12,92,73,165
61,1,12,131,92,223
62,1,12,112,90,202
63,1,12,124,105,229
64,1,12,195,180,375
65,1,12,56,69,125
66,1,12,32,31,63
67,1,12,75,71,146
68,1,12,194,149,343
69,1,12,175,254,429
70,1,12,121,133,254
71,1,12,216,220,436
72,1,12,40,60,100
73,1,12,158,149,307
74,1,12,77,56,133
75,1,12,53,61,114
76,1,12,58,87,145
77,1,12,101,105,206
78,1,12,77,85,162
79,1,12,60,61,121
80,1,12,75,80,155
81,1,12,33,39,72
82,1,12,79,69,148
83,1,12,127,159,286
84,1,12,53,61,114
85,1,12,82,95,177
86,1,12,52,38,90
87,1,12,149,144,293
88,1,12,34,52,86
89,1,12,81,75,156
90,1,12,202,208,410
91,1,12,234,189,423
92,1,12,41,73,114
93,1,12,80,78,158
94,1,12,31,34,65
95,1,12,22,29,51
96,1,12,183,196,379
97,1,12,99,94,193
98,1,12,39,35,74
99,1,12,169,155,324
100,1,12,139,126,265
101,1,12,137,122,259
102,1,12,85,110,195
103,1,12,202,194,396
104,1,12,91,117,208
105,1,12,101,69,170
106,1,12,42,50,92
107,1,12,90,70,160
108,1,12,148,151,299
109,1,12,53,70,123
110,1,12,118,121,239
111,1,12,159,138,297
112,1,12,62,76,138
113,1,12,68,89,157
114,1,12,76,65,141
115,1,12,102,155,257
116,1,12,69,85,154
117,1,12,65,53,118
118,1,12,49,64,113
119,1,12,124,108,232
120,1,12,43,57,100
121,1,12,127,120,247
122,1,12,55,38,93
123,1,12,190,179,369
124,1,12,2,6,8
125,1,12,57,50,107
126,1,12,56,31,87
127,1,12,58,66,124
128,1,12,17,32,49
129,1,12,101,99,200
130,1,12,91,102,193
131,1,12,176,137,313
132,1,12,99,103,202
133,1,12,46,59,105
134,1,12,148,115,263
135,1,12,92,88,180
136,1,12,43,62,105
137,1,12,11,13,24
138,1,12,95,79,174
139,1,12,45,53,98
140,1,12,165,189,354
141,1,12,224,212,436
142,1,12,128,134,262
143,1,12,81,100,181
144,1,12,25,19,44
145,1,12,100,116,216
146,1,12,57,90,147
147,1,12,25,34,59
148,1,12,22,31,53
149,1,12,58,72,130
150,1,12,7,21,28
151,1,12,65,37,102
152,1,12,123,111,234
153,1,12,27,65,92
154,1,12,185,231,416
155,1,12,217,211,428
156,1,12,96,116,212
157,1,12,64,54,118
158,1,12,37,35,72
159,1,12,64,78,142
160,1,12,45,35,80
161,1,12,117,92,209
162,1,12,19,32,51
163,1,12,42,27,69
164,1,12,34,52,86
165,1,12,111,174,285
166,1,12,188,174,362
167,1,12,22,38,60
168,1,12,203,191,394
169,1,12,38,44,82
170,1,12,268,217,485
171,1,12,65,77,142
172,1,12,55,43,98
173,1,12,207,212,419
174,1,12,83,74,157
175,1,12,65,72,137
176,1,12,33,36,69
177,1,12,88,72,160
178,1,12,118,91,209
179,1,12,44,47,91
180,1,12,58,39,97
181,1,12,114,118,232
182,1,12,81,91,172
183,1,12,107,96,203
184,1,12,189,227,416
185,1,12,37,31,68
186,1,12,272,282,554
187,1,12,183,184,367
188,1,12,166,148,314
189,1,12,1,2,3
190,1,12,66,93,159
191,1,12,100,117,217
192,1,12,52,41,93
193,1,12,89,97,186
194,1,12,87,63,150
195,1,12,130,99,229
196,1,12,48,45,93
197,1,12,30,48,78
198,1,12,69,30,99
199,1,12,1,0,1
200,1,12,38,28,66
201,1,12,194,127,321
202,1,12,0,1,1
203,1,12,219,192,411
204,1,12,355,344,699
205,1,12,22,50,72
206,1,12,3,9,12
207,1,12,114,89,203
208,1,12,3,10,13
209,1,12,343,328,671
210,1,12,10,18,28
211,1,12,153,125,278
212,1,12,4,6,10
213,1,12,74,87,161
214,1,12,93,37,130
215,1,12,363,347,710
216,1,12,3,9,12
217,1,12,25,39,64
218,1,12,92,103,195
219,1,12,110,53,163
220,1,12,49,49,98
221,1,12,179,194,373
222,1,12,301,300,601
223,1,12,81,65,146
224,1,12,19,13,32
225,1,12,4,7,11
226,1,12,225,247,472
227,1,12,3,3,6
228,1,12,57,33,90
229,1,12,11,23,34
230,1,12,65,60,125
231,1,12,125,76,201
232,1,12,51,54,105
233,1,12,161,159,320
234,1,12,93,60,153
235,1,12,6,6,12
236,1,12,151,121,272
237,1,12,122,137,259
238,1,12,71,86,157
239,1,12,32,26,58
240,1,12,168,144,312
241,1,12,55,82,137
242,1,12,127,128,255
243,1,12,97,103,200
244,1,12,103,91,194
245,1,12,96,90,186
246,1,12,28,34,62
247,1,12,116,80,196
248,1,12,154,132,286
249,1,12,187,175,362
250,1,12,63,61,124
251,1,12,38,48,86
252,1,12,29,38,67
253,1,12,70,67,137
254,1,12,108,94,202
255,1,12,67,66,133
256,1,12,145,86,231
257,1,12,437,595,1032
258,1,12,0,1,1
259,1,12,983,1190,2173
260,1,12,74,43,117
261,1,12,342,336,678
262,1,12,20,28,48
263,1,12,75,82,157
264,1,12,5,9,14
265,1,12,7,9,16
266,1,12,75,92,167
267,1,12,4,4,8
268,1,12,27,48,75
269,1,12,132,111,243
270,1,12,1,4,5
271,1,12,5,10,15
272,1,12,231,562,793
273,1,12,234,182,416
274,1,12,57,46,103
275,1,12,54,37,91
276,1,12,23,36,59
277,1,12,124,100,224
278,1,12,25,18,43
279,1,12,198,219,417
280,1,12,18,18,36
281,1,12,36,40,76
282,1,12,1,1,2
283,1,12,363,154,517
284,1,12,79,83,162
285,1,12,6,8,14
286,1,12,62,78,140
287,1,12,90,81,171
288,1,12,10,4,14
289,1,12,240,209,449
290,1,12,0,1,1
291,1,12,65,57,122
292,1,12,44,45,89
293,1,12,3,6,9
294,1,12,111,87,198
295,1,12,35,56,91
296,1,12,224,244,468
297,1,12,106,133,239
298,1,12,68,51,119
299,1,12,204,162,366
300,1,12,49,16,65
301,1,12,44,54,98
302,1,12,74,67,141
303,1,12,46,33,79
304,1,12,1,5,6
305,1,12,13,26,39
306,1,12,50,49,99
307,1,12,8,13,21
308,1,12,47,35,82
309,1,12,183,222,405
310,1,12,97,88,185
311,1,12,55,51,106
312,1,12,45,30,75
313,1,12,87,88,175
314,1,12,4,2,6
315,1,12,211,187,398
316,1,12,206,240,446
317,1,12,69,94,163
318,1,12,125,128,253
319,1,12,4,8,12
320,1,12,112,135,247
321,1,12,4,7,11
322,1,12,58,81,139
323,1,12,3,12,15
324,1,12,142,150,292
325,1,12,216,168,384
326,1,12,46,44,90
327,1,12,112,126,238
328,1,12,198,166,364
329,1,12,57,66,123
330,1,12,89,70,159
331,1,12,1042,1289,2331
332,1,12,27,14,41
333,1,12,166,201,367
334,1,12,212,172,384
335,1,12,135,143,278
336,1,12,154,113,267
337,1,12,46,43,89
338,1,12,75,85,160
339,1,12,28,28,56
340,1,12,12,13,25
341,1,12,32,28,60
342,1,12,77,77,154
343,1,12,40,45,85
344,1,12,292,289,581
345,1,12,228,192,420
346,1,12,127,83,210
347,1,12,97,78,175
348,1,12,96,80,176
349,1,12,182,188,370
350,1,12,49,53,102
351,1,12,52,57,109
352,1,12,41,48,89
353,1,12,142,152,294
354,1,12,34,33,67
355,1,12,62,55,117
356,1,12,180,157,337
357,1,12,16,34,50
358,1,12,78,57,135
359,1,12,51,56,107
360,1,12,116,101,217
361,1,12,41,27,68
362,1,12,141,124,265
363,1,12,45,36,81
364,1,12,125,103,228
365,1,12,111,103,214
366,1,12,135,70,205
367,1,12,135,97,232
368,1,12,21,40,61
369,1,12,71,57,128
370,1,12,16,12,28
371,1,12,115,86,201
372,1,12,114,112,226
373,1,12,32,29,61
374,1,12,121,102,223
375,1,12,38,43,81
376,1,12,111,138,249
377,1,12,128,131,259
378,1,12,58,54,112
379,1,12,70,56,126
380,1,12,83,71,154
381,1,12,12,22,34
382,1,12,148,155,303
383,1,12,81,82,163
384,1,12,119,114,233
385,1,12,22,32,54
386,1,12,78,69,147
387,1,12,28,26,54
388,1,12,67,66,133
389,1,12,0,1,1
390,1,12,696,750,1446
391,1,12,52,39,91
392,1,12,33,51,84
393,1,12,204,198,402
394,1,12,104,93,197
395,1,12,177,204,381
396,1,12,87,90,177
397,1,12,44,38,82
398,1,12,95,123,218
399,1,12,60,51,111
400,1,12,47,38,85
401,1,12,45,35,80
402,1,12,38,54,92
403,1,12,140,94,234
404,1,12,15,30,45
405,1,12,456,544,1000
406,1,12,149,153,302
407,1,12,11,19,30
408,1,12,120,128,248
409,1,12,34,46,80
410,1,12,74,112,186
411,1,12,141,84,225
412,1,12,2,9,11
413,1,12,15,17,32
414,1,12,20,30,50
415,1,12,49,70,119
416,1,12,99,82,181
417,1,12,16,24,40
418,1,12,118,121,239
419,1,12,80,70,150
420,1,12,108,144,252
421,1,12,185,115,300
422,1,12,246,281,527
423,1,12,5,15,20
424,1,12,0,1,1
0,1,15,245,387,632
1,1,15,63,51,114
2,1,15,158,137,295
3,1,15,122,95,217
4,1,15,89,100,189
5,1,15,154,168,322
6,1,15,72,67,139
7,1,15,80,89,169
8,1,15,140,110,250
9,1,15,64,74,138
10,1,15,127,119,246
11,1,15,52,61,113
12,1,15,53,50,103
13,1,15,115,102,217
14,1,15,133,128,261
15,1,15,199,141,340
16,1,15,227,189,416
17,1,15,87,89,176
18,1,15,80,96,176
19,1,15,33,53,86
20,1,15,67,71,138
21,1,15,123,118,241
22,1,15,36,48,84
23,1,15,133,143,276
24,1,15,254,247,501
25,1,15,61,67,128
26,1,15,167,130,297
27,1,15,73,91,164
28,1,15,139,120,259
29,1,15,125,133,258
30,1,15,85,93,178
31,1,15,91,95,186
32,1,15,228,237,465
33,1,15,518,497,1015
34,1,15,43,58,101
35,1,15,88,106,194
36,1,15,122,128,250
37,1,15,27,31,58
38,1,15,25,27,52
39,1,15,153,122,275
40,1,15,51,55,106
41,1,15,48,72,120
42,1,15,93,199,292
43,1,15,73,100,173
44,1,15,28,38,66
45,1,15,102,74,176
46,1,15,73,81,154
47,1,15,23,23,46
48,1,15,157,102,259
49,1,15,88,133,221
50,1,15,26,40,66
51,1,15,88,120,208
52,1,15,137,165,302
53,1,15,0,0,0
54,1,15,34,26,60
55,1,15,325,220,545
56,1,15,16,23,39
57,1,15,184,204,388
58,1,15,153,143,296
59,1,15,727,543,1270
60,1,15,111,90,201
61,1,15,102,86,188
62,1,15,114,76,190
63,1,15,111,86,197
64,1,15,180,163,343
65,1,15,71,85,156
66,1,15,37,34,71
67,1,15,67,60,127
68,1,15,144,155,299
69,1,15,216,193,409
70,1,15,112,77,189
71,1,15,188,202,390
72,1,15,23,22,45
73,1,15,134,120,254
74,1,15,64,42,106
75,1,15,71,92,163
76,1,15,60,73,133
77,1,15,87,98,185
78,1,15,70,45,115
79,1,15,38,34,72
80,1,15,78,66,144
81,1,15,34,43,77
82,1,15,73,69,142
83,1,15,160,172,332
84,1,15,47,38,85
85,1,15,83,83,166
86,1,15,53,39,92
87,1,15,148,176,324
88,1,15,38,56,94
89,1,15,58,55,113
90,1,15,141,111,252
91,1,15,293,216,509
92,1,15,29,74,103
93,1,15,81,98,179
94,1,15,27,21,48
95,1,15,27,35,62
96,1,15,185,153,338
97,1,15,87,118,205
98,1,15,37,38,75
99,1,15,206,167,373
100,1,15,117,122,239
101,1,15,142,161,303
102,1,15,77,67,144
103,1,15,206,175,381
104,1,15,79,85,164
105,1,15,71,67,138
106,1,15,32,55,87
107,1,15,58,69,127
108,1,15,159,143,302
109,1,15,44,72,116
110,1,15,95,75,170
111,1,15,169,172,341
112,1,15,89,95,184
113,1,15,63,94,157
114,1,15,95,109,204
115,1,15,108,154,262
116,1,15,65,59,124
117,1,15,59,75,134
118,1,15,48,56,104
119,1,15,133,129,262
120,1,15,52,49,101
121,1,15,88,82,170
122,1,15,29,35,64
123,1,15,169,218,387
124,1,15,1,3,4
125,1,15,38,43,81
126,1,15,31,40,71
127,1,15,74,68,142
128,1,15,14,24,38
129,1,15,80,91,171
130,1,15,117,124,241
131,1,15,151,136,287
132,1,15,88,85,173
133,1,15,41,54,95
134,1,15,164,130,294
135,1,15,157,144,301
136,1,15,71,67,138
137,1,15,9,1,10
138,1,15,49,51,100
139,1,15,31,32,63
140,1,15,162,217,379
141,1,15,207,266,473
142,1,15,78,63,141
143,1,15,92,80,172
144,1,15,24,20,44
145,1,15,124,150,274
146,1,15,37,58,95
147,1,15,48,52,100
148,1,15,21,20,41
149,1,15,46,75,121
150,1,15,3,9,12
151,1,15,54,47,101
152,1,15,73,86,159
153,1,15,44,50,94
154,1,15,346,355,701
155,1,15,210,162,372
156,1,15,72,82,154
157,1,15,69,34,103
158,1,15,23,29,52
159,1,15,74,106,180
160,1,15,41,41,82
161,1,15,91,78,169
162,1,15,17,23,40
163,1,15,29,42,71
164,1,15,38,41,79
165,1,15,97,84,181
166,1,15,166,171,337
167,1,15,15,31,46
168,1,15,58,60,118
169,1,15,55,69,124
170,1,15,203,193,396
171,1,15,59,67,126
172,1,15,50,42,92
173,1,15,218,215,433
174,1,15,39,65,104
175,1,15,71,44,115
176,1,15,39,49,88
177,1,15,121,93,214
178,1,15,67,74,141
179,1,15,66,63,129
180,1,15,82,46,128
181,1,15,100,119,219
182,1,15,61,45,106
183,1,15,117,107,224
184,1,15,170,113,283
185,1,15,56,47,103
186,1,15,204,172,376
187,1,15,163,161,324
188,1,15,172,233,405
189,1,15,1,4,5
190,1,15,66,85,151
191,1,15,91,89,180
192,1,15,34,32,66
193,1,15,70,97,167
194,1,15,51,52,103
195,1,15,95,126,221
196,1,15,41,40,81
197,1,15,32,60,92
198,1,15,54,46,100
199,1,15,0,1,1
200,1,15,27,38,65
201,1,15,154,127,281
202,1,15,0,0,0
203,1,15,230,168,398
204,1,15,390,318,708
205,1,15,27,54,81
206,1,15,6,9,15
207,1,15,107,68,175
208,1,15,0,2,2
209,1,15,295,289,584
210,1,15,11,16,27
211,1,15,132,108,240
212,1,15,0,1,1
213,1,15,69,55,124
214,1,15,110,43,153
215,1,15,355,334,689
216,1,15,4,3,7
217,1,15,23,21,44
218,1,15,76,81,157
219,1,15,68,48,116
220,1,15,44,56,100
221,1,15,248,224,472
222,1,15,374,400,774
223,1,15,49,44,93
224,1,15,21,20,41
225,1,15,11,9,20
226,1,15,316,288,604
227,1,15,1,4,5
228,1,15,40,38,78
229,1,15,11,16,27
230,1,15,90,82,172
231,1,15,92,64,156
232,1,15,41,58,99
233,1,15,185,182,367
234,1,15,58,60,118
235,1,15,5,5,10
236,1,15,97,61,158
237,1,15,89,142,231
238,1,15,64,71,135
239,1,15,18,22,40
240,1,15,117,124,241
241,1,15,40,63,103
242,1,15,100,76,176
243,1,15,86,132,218
244,1,15,131,133,264
245,1,15,68,55,123
246,1,15,27,43,70
247,1,15,77,65,142
248,1,15,134,109,243
249,1,15,141,99,240
250,1,15,41,42,83
251,1,15,25,37,62
252,1,15,23,36,59
253,1,15,69,47,116
254,1,15,73,60,133
255,1,15,44,41,85
256,1,15,112,79,191
257,1,15,273,491,764
258,1,15,1,0,1
259,1,15,826,853,1679
260,1,15,63,29,92
261,1,15,128,134,262
262,1,15,18,29,47
263,1,15,57,60,117
264,1,15,1,6,7
265,1,15,5,6,11
266,1,15,41,27,68
267,1,15,2,2,4
268,1,15,28,24,52
269,1,15,79,93,172
270,1,15,1,1,2
271,1,15,3,2,5
272,1,15,151,348,499
273,1,15,181,155,336
274,1,15,52,68,120
275,1,15,34,30,64
276,1,15,12,18,30
277,1,15,104,100,204
278,1,15,30,20,50
279,1,15,243,242,485
280,1,15,13,18,31
281,1,15,27,19,46
282,1,15,0,4,4
283,1,15,257,112,369
284,1,15,73,85,158
285,1,15,5,5,10
286,1,15,45,42,87
287,1,15,58,67,125
288,1,15,1,3,4
289,1,15,158,178,336
290,1,15,0,0,0
291,1,15,93,89,182
292,1,15,49,34,83
293,1,15,0,3,3
294,1,15,101,92,193
295,1,15,35,40,75
296,1,15,132,192,324
297,1,15,91,118,209
298,1,15,40,41,81
299,1,15,168,146,314
300,1,15,24,33,57
301,1,15,41,23,64
302,1,15,73,69,142
303,1,15,26,16,42
304,1,15,1,1,2
305,1,15,6,26,32
306,1,15,47,29,76
307,1,15,3,10,13
308,1,15,41,47,88
309,1,15,127,124,251
310,1,15,75,76,151
311,1,15,46,54,100
312,1,15,30,25,55
313,1,15,75,71,146
314,1,15,1,3,4
315,1,15,204,215,419
316,1,15,111,98,209
317,1,15,39,42,81
318,1,15,68,54,122
319,1,15,2,5,7
320,1,15,84,70,154
321,1,15,6,12,18
322,1,15,36,28,64
323,1,15,0,2,2
324,1,15,104,121,225
325,1,15,137,79,216
326,1,15,39,40,79
327,1,15,60,49,109
328,1,15,84,66,150
329,1,15,24,38,62
330,1,15,75,53,128
331,1,15,931,1066,1997
332,1,15,14,13,27
333,1,15,49,49,98
334,1,15,223,149,372
335,1,15,143,161,304
336,1,15,89,60,149
337,1,15,13,21,34
338,1,15,68,61,129
339,1,15,28,42,70
340,1,15,9,10,19
341,1,15,27,18,45
342,1,15,73,68,141
343,1,15,57,40,97
344,1,15,179,151,330
345,1,15,155,135,290
346,1,15,85,72,157
347,1,15,108,71,179
348,1,15,63,51,114
349,1,15,78,66,144
350,1,15,35,41,76
351,1,15,70,71,141
352,1,15,34,35,69
353,1,15,107,81,188
354,1,15,21,24,45
355,1,15,48,43,91
356,1,15,135,109,244
357,1,15,14,13,27
358,1,15,78,45,123
359,1,15,54,51,105
360,1,15,93,99,192
361,1,15,30,19,49
362,1,15,108,114,222
363,1,15,27,28,55
364,1,15,90,89,179
365,1,15,104,141,245
366,1,15,63,44,107
367,1,15,117,124,241
368,1,15,21,36,57
369,1,15,35,45,80
370,1,15,4,6,10
371,1,15,89,67,156
372,1,15,87,68,155
373,1,15,26,28,54
374,1,15,81,53,134
375,1,15,19,24,43
376,1,15,85,109,194
377,1,15,115,121,236
378,1,15,54,45,99
379,1,15,67,49,116
380,1,15,40,53,93
381,1,15,14,21,35
382,1,15,78,76,154
383,1,15,46,43,89
384,1,15,83,92,175
385,1,15,15,18,33
386,1,15,79,76,155
387,1,15,23,14,37
388,1,15,54,35,89
389,1,15,0,0,0
390,1,15,633,674,1307
391,1,15,31,34,65
392,1,15,26,54,80
393,1,15,164,185,349
394,1,15,110,102,212
395,1,15,157,137,294
396,1,15,85,62,147
397,1,15,26,39,65
398,1,15,74,124,198
399,1,15,62,43,105
400,1,15,29,30,59
401,1,15,45,32,77
402,1,15,51,54,105
403,1,15,137,100,237
404,1,15,9,9,18
405,1,15,363,426,789
406,1,15,177,190,367
407,1,15,7,21,28
408,1,15,176,207,383
409,1,15,40,42,82
410,1,15,94,158,252
411,1,15,163,150,313
412,1,15,0,7,7
413,1,15,11,18,29
414,1,15,18,34,52
415,1,15,67,84,151
416,1,15,71,62,133
417,1,15,14,29,43
418,1,15,96,88,184
419,1,15,71,62,133
420,1,15,89,138,227
421,1,15,161,111,272
422,1,15,129,139,268
423,1,15,2,11,13
424,1,15,1,3,4
0,1,18,394,503,897
1,1,18,88,75,163
2,1,18,189,134,323
3,1,18,150,151,301
4,1,18,103,119,222
5,1,18,246,279,525
6,1,18,74,92,166
7,1,18,96,125,221
8,1,18,158,115,273
9,1,18,81,108,189
10,1,18,189,207,396
11,1,18,68,58,126
12,1,18,63,84,147
13,1,18,191,183,374
14,1,18,82,76,158
15,1,18,186,125,311
16,1,18,221,216,437
17,1,18,139,133,272
18,1,18,131,143,274
19,1,18,89,99,188
20,1,18,61,57,118
21,1,18,164,103,267
22,1,18,35,55,90
23,1,18,119,137,256
24,1,18,172,192,364
25,1,18,97,103,200
26,1,18,191,174,365
27,1,18,78,122,200
28,1,18,244,147,391
29,1,18,195,213,408
30,1,18,88,120,208
31,1,18,112,113,225
32,1,18,277,268,545
33,1,18,409,384,793
34,1,18,76,61,137
35,1,18,167,172,339
36,1,18,164,209,373
37,1,18,25,54,79
38,1,18,21,17,38
39,1,18,116,105,221
40,1,18,61,60,121
41,1,18,90,88,178
42,1,18,178,293,471
43,1,18,91,127,218
44,1,18,33,42,75
45,1,18,101,66,167
46,1,18,114,122,236
47,1,18,22,34,56
48,1,18,142,120,262
49,1,18,153,199,352
50,1,18,18,65,83
51,1,18,111,189,300
52,1,18,173,239,412
53,1,18,0,0,0
54,1,18,30,29,59
55,1,18,251,196,447
56,1,18,22,34,56
57,1,18,184,129,313
58,1,18,131,106,237
59,1,18,374,185,559
60,1,18,96,89,185
61,1,18,174,141,315
62,1,18,118,116,234
63,1,18,167,177,344
64,1,18,133,163,296
65,1,18,93,113,206
66,1,18,39,36,75
67,1,18,88,97,185
68,1,18,173,177,350
69,1,18,219,170,389
70,1,18,138,102,240
71,1,18,252,287,539
72,1,18,13,17,30
73,1,18,165,140,305
74,1,18,83,74,157
75,1,18,42,80,122
76,1,18,69,58,127
77,1,18,89,117,206
78,1,18,64,66,130
79,1,18,43,48,91
80,1,18,95,95,190
81,1,18,74,121,195
82,1,18,95,90,185
83,1,18,135,163,298
84,1,18,75,57,132
85,1,18,111,154,265
86,1,18,62,42,104
87,1,18,252,317,569
88,1,18,29,63,92
89,1,18,76,51,127
90,1,18,158,136,294
91,1,18,251,220,471
92,1,18,30,80,110
93,1,18,102,131,233
94,1,18,35,38,73
95,1,18,9,17,26
96,1,18,139,142,281
97,1,18,108,137,245
98,1,18,43,42,85
99,1,18,172,211,383
100,1,18,200,207,407
101,1,18,191,232,423
102,1,18,90,49,139
103,1,18,184,158,342
104,1,18,57,88,145
105,1,18,95,65,160
106,1,18,45,85,130
107,1,18,108,210,318
108,1,18,141,189,330
109,1,18,72,91,163
110,1,18,122,88,210
111,1,18,186,234,420
112,1,18,61,59,120
113,1,18,60,81,141
114,1,18,117,159,276
115,1,18,125,161,286
116,1,18,98,86,184
117,1,18,60,72,132
118,1,18,84,106,190
119,1,18,175,215,390
120,1,18,63,80,143
121,1,18,132,100,232
122,1,18,55,33,88
123,1,18,237,397,634
124,1,18,1,9,10
125,1,18,93,76,169
126,1,18,73,62,135
127,1,18,59,37,96
128,1,18,30,43,73
129,1,18,147,155,302
130,1,18,105,127,232
131,1,18,181,188,369
132,1,18,75,88,163
133,1,18,60,96,156
134,1,18,148,158,306
135,1,18,121,135,256
136,1,18,54,77,131
137,1,18,21,14,35
138,1,18,79,89,168
139,1,18,50,35,85
140,1,18,264,370,634
141,1,18,339,373,712
142,1,18,95,70,165
143,1,18,67,67,134
144,1,18,36,15,51
145,1,18,96,115,211
146,1,18,55,74,129
147,1,18,22,49,71
148,1,18,12,14,26
149,1,18,48,108,156
150,1,18,21,80,101
151,1,18,84,67,151
152,1,18,89,103,192
153,1,18,25,50,75
154,1,18,217,237,454
155,1,18,224,137,361
156,1,18,98,73,171
157,1,18,90,55,145
158,1,18,52,34,86
159,1,18,90,103,193
160,1,18,66,54,120
161,1,18,165,130,295
162,1,18,18,25,43
163,1,18,34,61,95
164,1,18,52,55,107
165,1,18,76,35,111
166,1,18,277,243,520
167,1,18,33,39,72
168,1,18,24,40,64
169,1,18,28,52,80
170,1,18,280,280,560
171,1,18,70,59,129
172,1,18,31,38,69
173,1,18,254,257,511
174,1,18,75,126,201
175,1,18,81,53,134
176,1,18,29,37,66
177,1,18,110,103,213
178,1,18,74,38,112
179,1,18,41,51,92
180,1,18,60,42,102
181,1,18,134,146,280
182,1,18,51,46,97
183,1,18,181,160,341
184,1,18,312,145,457
185,1,18,36,48,84
186,1,18,274,222,496
187,1,18,291,410,701
188,1,18,253,255,508
189,1,18,0,1,1
190,1,18,63,93,156
191,1,18,110,91,201
192,1,18,69,47,116
193,1,18,82,117,199
194,1,18,93,107,200
195,1,18,150,182,332
196,1,18,77,63,140
197,1,18,32,53,85
198,1,18,115,64,179
199,1,18,1,1,2
200,1,18,31,73,104
201,1,18,174,164,338
202,1,18,0,1,1
203,1,18,251,218,469
204,1,18,352,303,655
205,1,18,21,49,70
206,1,18,2,13,15
207,1,18,148,128,276
208,1,18,2,7,9
209,1,18,337,345,682
210,1,18,9,9,18
211,1,18,225,145,370
212,1,18,1,2,3
213,1,18,80,85,165
214,1,18,89,26,115
215,1,18,347,258,605
216,1,18,3,5,8
217,1,18,57,40,97
218,1,18,96,111,207
219,1,18,93,96,189
220,1,18,83,72,155
221,1,18,288,370,658
222,1,18,365,385,750
223,1,18,88,133,221
224,1,18,37,30,67
225,1,18,11,11,22
226,1,18,202,196,398
227,1,18,0,6,6
228,1,18,46,49,95
229,1,18,14,21,35
230,1,18,74,83,157
231,1,18,156,121,277
232,1,18,62,71,133
233,1,18,151,217,368
234,1,18,163,143,306
235,1,18,6,4,10
236,1,18,107,88,195
237,1,18,240,344,584
238,1,18,83,95,178
239,1,18,61,54,115
240,1,18,244,180,424
241,1,18,80,85,165
242,1,18,124,109,233
243,1,18,99,154,253
244,1,18,134,130,264
245,1,18,143,122,265
246,1,18,40,88,128
247,1,18,132,90,222
248,1,18,231,123,354
249,1,18,166,107,273
250,1,18,76,75,151
251,1,18,28,52,80
252,1,18,45,54,99
253,1,18,131,163,294
254,1,18,129,68,197
255,1,18,58,43,101
256,1,18,150,68,218
257,1,18,451,484,935
258,1,18,0,3,3
259,1,18,876,635,1511
260,1,18,101,41,142
261,1,18,15,15,30
262,1,18,27,55,82
263,1,18,84,109,193
264,1,18,2,11,13
265,1,18,9,10,19
266,1,18,50,36,86
267,1,18,2,4,6
268,1,18,16,17,33
269,1,18,206,203,409
270,1,18,0,0,0
271,1,18,3,5,8
272,1,18,131,155,286
273,1,18,281,171,452
274,1,18,74,92,166
275,1,18,57,74,131
276,1,18,15,28,43
277,1,18,157,170,327
278,1,18,36,19,55
279,1,18,259,184,443
280,1,18,10,13,23
281,1,18,63,55,118
282,1,18,1,6,7
283,1,18,271,158,429
284,1,18,77,119,196
285,1,18,6,11,17
286,1,18,75,56,131
287,1,18,153,174,327
288,1,18,4,11,15
289,1,18,348,317,665
290,1,18,0,1,1
291,1,18,68,80,148
292,1,18,13,26,39
293,1,18,0,3,3
294,1,18,143,125,268
295,1,18,62,53,115
296,1,18,260,250,510
297,1,18,218,236,454
298,1,18,139,161,300
299,1,18,382,310,692
300,1,18,44,38,82
301,1,18,47,24,71
302,1,18,86,83,169
303,1,18,43,38,81
304,1,18,0,3,3
305,1,18,48,88,136
306,1,18,69,57,126
307,1,18,2,8,10
308,1,18,99,74,173
309,1,18,231,152,383
310,1,18,164,121,285
311,1,18,75,76,151
312,1,18,54,55,109
313,1,18,47,40,87
314,1,18,1,2,3
315,1,18,273,275,548
316,1,18,129,94,223
317,1,18,47,47,94
318,1,18,51,66,117
319,1,18,1,6,7
320,1,18,119,123,242
321,1,18,4,11,15
322,1,18,82,49,131
323,1,18,1,1,2
324,1,18,139,141,280
325,1,18,177,100,277
326,1,18,61,45,106
327,1,18,55,54,109
328,1,18,85,97,182
329,1,18,58,62,120
330,1,18,133,86,219
331,1,18,779,571,1350
332,1,18,33,20,53
333,1,18,42,71,113
334,1,18,164,123,287
335,1,18,132,180,312
336,1,18,158,131,289
337,1,18,44,42,86
338,1,18,61,86,147
339,1,18,39,58,97
340,1,18,23,35,58
341,1,18,39,43,82
342,1,18,108,127,235
343,1,18,67,39,106
344,1,18,267,197,464
345,1,18,264,282,546
346,1,18,138,103,241
347,1,18,127,74,201
348,1,18,114,91,205
349,1,18,113,111,224
350,1,18,35,57,92
351,1,18,49,92,141
352,1,18,51,61,112
353,1,18,116,122,238
354,1,18,47,47,94
355,1,18,89,49,138
356,1,18,203,181,384
357,1,18,15,36,51
358,1,18,83,100,183
359,1,18,50,88,138
360,1,18,87,116,203
361,1,18,27,23,50
362,1,18,169,196,365
363,1,18,27,22,49
364,1,18,169,169,338
365,1,18,162,167,329
366,1,18,126,64,190
367,1,18,162,204,366
368,1,18,36,38,74
369,1,18,77,62,139
370,1,18,9,17,26
371,1,18,134,110,244
372,1,18,80,76,156
373,1,18,40,44,84
374,1,18,119,105,224
375,1,18,83,63,146
376,1,18,238,211,449
377,1,18,271,336,607
378,1,18,64,89,153
379,1,18,85,82,167
380,1,18,117,78,195
381,1,18,13,36,49
382,1,18,97,104,201
383,1,18,66,42,108
384,1,18,153,168,321
385,1,18,21,38,59
386,1,18,84,95,179
387,1,18,35,48,83
388,1,18,44,58,102
389,1,18,0,0,0
390,1,18,751,584,1335
391,1,18,18,40,58
392,1,18,39,58,97
393,1,18,189,214,403
394,1,18,69,85,154
395,1,18,173,128,301
396,1,18,88,79,167
397,1,18,31,32,63
398,1,18,92,149,241
399,1,18,45,35,80
400,1,18,22,25,47
401,1,18,32,15,47
402,1,18,22,25,47
403,1,18,74,70,144
404,1,18,8,14,22
405,1,18,368,392,760
406,1,18,122,139,261
407,1,18,8,24,32
408,1,18,139,183,322
409,1,18,39,46,85
410,1,18,83,140,223
411,1,18,184,159,343
412,1,18,4,8,12
413,1,18,17,35,52
414,1,18,25,46,71
415,1,18,39,65,104
416,1,18,120,134,254
417,1,18,8,14,22
418,1,18,148,116,264
419,1,18,122,131,253
420,1,18,205,299,504
421,1,18,212,169,381
422,1,18,85,132,217
423,1,18,1,7,8
424,1,18,2,2,4
0,1,21,420,277,697
1,1,21,69,78,147
2,1,21,247,134,381
3,1,21,163,222,385
4,1,21,129,157,286
5,1,21,348,388,736
6,1,21,115,98,213
7,1,21,112,165,277
8,1,21,143,158,301
9,1,21,80,159,239
10,1,21,222,285,507
11,1,21,37,63,100
12,1,21,92,114,206
13,1,21,176,228,404
14,1,21,106,121,227
15,1,21,172,89,261
16,1,21,190,230,420
17,1,21,209,194,403
18,1,21,183,213,396
19,1,21,79,108,187
20,1,21,87,83,170
21,1,21,179,94,273
22,1,21,29,42,71
23,1,21,90,154,244
24,1,21,195,252,447
25,1,21,110,190,300
26,1,21,283,219,502
27,1,21,95,135,230
28,1,21,165,220,385
29,1,21,191,270,461
30,1,21,104,94,198
31,1,21,105,125,230
32,1,21,317,309,626
33,1,21,302,293,595
34,1,21,84,59,143
35,1,21,204,182,386
36,1,21,178,310,488
37,1,21,34,49,83
38,1,21,20,15,35
39,1,21,90,109,199
40,1,21,67,49,116
41,1,21,69,77,146
42,1,21,170,311,481
43,1,21,103,132,235
44,1,21,31,27,58
45,1,21,139,123,262
46,1,21,111,154,265
47,1,21,25,22,47
48,1,21,170,122,292
49,1,21,173,324,497
50,1,21,25,84,109
51,1,21,135,190,325
52,1,21,169,191,360
53,1,21,1,3,4
54,1,21,42,28,70
55,1,21,203,147,350
56,1,21,21,44,65
57,1,21,137,167,304
58,1,21,110,107,217
59,1,21,184,195,379
60,1,21,93,106,199
61,1,21,142,131,273
62,1,21,111,107,218
63,1,21,195,158,353
64,1,21,137,174,311
65,1,21,114,117,231
66,1,21,55,36,91
67,1,21,77,89,166
68,1,21,158,193,351
69,1,21,297,222,519
70,1,21,154,93,247
71,1,21,235,213,448
72,1,21,12,19,31
73,1,21,247,195,442
74,1,21,84,93,177
75,1,21,67,62,129
76,1,21,62,67,129
77,1,21,94,170,264
78,1,21,59,59,118
79,1,21,38,47,85
80,1,21,82,75,157
81,1,21,120,77,197
82,1,21,97,93,190
83,1,21,109,146,255
84,1,21,52,23,75
85,1,21,167,238,405
86,1,21,44,30,74
87,1,21,355,380,735
88,1,21,49,103,152
89,1,21,82,53,135
90,1,21,119,79,198
91,1,21,222,146,368
92,1,21,42,140,182
93,1,21,66,106,172
94,1,21,26,40,66
95,1,21,8,8,16
96,1,21,144,91,235
97,1,21,86,89,175
98,1,21,43,50,93
99,1,21,170,161,331
100,1,21,182,177,359
101,1,21,192,223,415
102,1,21,51,58,109
103,1,21,160,122,282
104,1,21,47,104,151
105,1,21,106,64,170
106,1,21,42,110,152
107,1,21,148,137,285
108,1,21,170,184,354
109,1,21,56,78,134
110,1,21,105,47,152
111,1,21,240,194,434
112,1,21,60,83,143
113,1,21,33,68,101
114,1,21,135,157,292
115,1,21,120,167,287
116,1,21,59,84,143
117,1,21,53,78,131
118,1,21,103,138,241
119,1,21,203,218,421
120,1,21,56,95,151
121,1,21,97,52,149
122,1,21,76,55,131
123,1,21,235,324,559
124,1,21,2,8,10
125,1,21,80,73,153
126,1,21,60,71,131
127,1,21,62,45,107
128,1,21,27,43,70
129,1,21,151,139,290
130,1,21,98,183,281
131,1,21,158,176,334
132,1,21,79,66,145
133,1,21,50,74,124
134,1,21,168,165,333
135,1,21,148,150,298
136,1,21,54,78,132
137,1,21,16,24,40
138,1,21,78,54,132
139,1,21,48,54,102
140,1,21,266,332,598
141,1,21,337,496,833
142,1,21,63,47,110
143,1,21,40,65,105
144,1,21,20,15,35
145,1,21,87,131,218
146,1,21,59,97,156
147,1,21,29,60,89
148,1,21,14,14,28
149,1,21,70,133,203
150,1,21,24,40,64
151,1,21,76,84,160
152,1,21,57,119,176
153,1,21,20,20,40
154,1,21,192,209,401
155,1,21,192,128,320
156,1,21,66,75,141
157,1,21,84,71,155
158,1,21,56,36,92
159,1,21,76,107,183
160,1,21,69,47,116
161,1,21,160,170,330
162,1,21,11,25,36
163,1,21,37,50,87
164,1,21,57,57,114
165,1,21,28,6,34
166,1,21,193,74,267
167,1,21,16,30,46
168,1,21,9,31,40
169,1,21,38,45,83
170,1,21,264,275,539
171,1,21,22,38,60
172,1,21,21,28,49
173,1,21,280,246,526
174,1,21,73,78,151
175,1,21,94,54,148
176,1,21,20,23,43
177,1,21,96,108,204
178,1,21,40,22,62
179,1,21,25,34,59
180,1,21,66,57,123
181,1,21,118,189,307
182,1,21,44,37,81
183,1,21,172,151,323
184,1,21,331,152,483
185,1,21,52,45,97
186,1,21,243,181,424
187,1,21,382,298,680
188,1,21,223,278,501
189,1,21,2,0,2
190,1,21,65,125,190
191,1,21,69,74,143
192,1,21,63,62,125
193,1,21,74,91,165
194,1,21,122,137,259
195,1,21,120,198,318
196,1,21,58,69,127
197,1,21,33,70,103
198,1,21,101,32,133
199,1,21,1,1,2
200,1,21,35,102,137
201,1,21,171,147,318
202,1,21,1,1,2
203,1,21,216,167,383
204,1,21,365,354,719
205,1,21,24,63,87
206,1,21,3,11,14
207,1,21,118,159,277
208,1,21,1,2,3
209,1,21,316,264,580
210,1,21,6,7,13
211,1,21,195,151,346
212,1,21,1,1,2
213,1,21,57,55,112
214,1,21,88,55,143
215,1,21,245,160,405
216,1,21,11,11,22
217,1,21,10,12,22
218,1,21,81,26,107
219,1,21,71,82,153
220,1,21,21,11,32
221,1,21,300,410,710
222,1,21,386,411,797
223,1,21,90,46,136
224,1,21,39,10,49
225,1,21,2,2,4
226,1,21,190,260,450
227,1,21,1,6,7
228,1,21,38,59,97
229,1,21,16,31,47
230,1,21,56,89,145
231,1,21,132,140,272
232,1,21,54,73,127
233,1,21,239,240,479
234,1,21,116,85,201
235,1,21,5,3,8
236,1,21,74,79,153
237,1,21,147,110,257
238,1,21,88,48,136
239,1,21,49,43,92
240,1,21,172,82,254
241,1,21,99,65,164
242,1,21,114,56,170
243,1,21,97,232,329
244,1,21,173,147,320
245,1,21,139,99,238
246,1,21,50,58,108
247,1,21,128,59,187
248,1,21,201,103,304
249,1,21,131,103,234
250,1,21,76,65,141
251,1,21,22,50,72
252,1,21,36,69,105
253,1,21,130,87,217
254,1,21,84,66,150
255,1,21,62,40,102
256,1,21,87,59,146
257,1,21,331,327,658
258,1,21,0,2,2
259,1,21,649,403,1052
260,1,21,56,28,84
261,1,21,16,24,40
262,1,21,41,78,119
263,1,21,111,89,200
264,1,21,5,14,19
265,1,21,7,11,18
266,1,21,32,29,61
267,1,21,2,3,5
268,1,21,12,10,22
269,1,21,115,55,170
270,1,21,1,0,1
271,1,21,1,4,5
272,1,21,131,114,245
273,1,21,264,134,398
274,1,21,66,80,146
275,1,21,60,44,104
276,1,21,22,29,51
277,1,21,129,156,285
278,1,21,40,12,52
279,1,21,211,119,330
280,1,21,16,34,50
281,1,21,52,25,77
282,1,21,0,1,1
283,1,21,135,180,315
284,1,21,104,117,221
285,1,21,10,12,22
286,1,21,53,35,88
287,1,21,102,51,153
288,1,21,5,10,15
289,1,21,207,95,302
290,1,21,0,1,1
291,1,21,43,54,97
292,1,21,9,18,27
293,1,21,0,4,4
294,1,21,159,130,289
295,1,21,32,21,53
296,1,21,200,142,342
297,1,21,133,75,208
298,1,21,75,135,210
299,1,21,198,86,284
300,1,21,43,52,95
301,1,21,35,25,60
302,1,21,73,48,121
303,1,21,35,49,84
304,1,21,0,3,3
305,1,21,53,112,165
306,1,21,73,50,123
307,1,21,3,8,11
308,1,21,61,54,115
309,1,21,85,45,130
310,1,21,149,81,230
311,1,21,72,59,131
312,1,21,60,66,126
313,1,21,44,29,73
314,1,21,1,2,3
315,1,21,232,274,506
316,1,21,79,65,144
317,1,21,50,30,80
318,1,21,41,66,107
319,1,21,1,5,6
320,1,21,104,62,166
321,1,21,1,9,10
322,1,21,46,45,91
323,1,21,0,2,2
324,1,21,111,62,173
325,1,21,131,69,200
326,1,21,43,20,63
327,1,21,38,37,75
328,1,21,67,111,178
329,1,21,60,91,151
330,1,21,73,90,163
331,1,21,554,273,827
332,1,21,33,26,59
333,1,21,30,84,114
334,1,21,145,117,262
335,1,21,169,205,374
336,1,21,141,99,240
337,1,21,26,44,70
338,1,21,40,74,114
339,1,21,52,55,107
340,1,21,22,40,62
341,1,21,31,30,61
342,1,21,116,65,181
343,1,21,27,12,39
344,1,21,170,125,295
345,1,21,269,141,410
346,1,21,121,125,246
347,1,21,113,51,164
348,1,21,121,95,216
349,1,21,74,107,181
350,1,21,37,83,120
351,1,21,40,82,122
352,1,21,39,80,119
353,1,21,116,128,244
354,1,21,43,56,99
355,1,21,72,75,147
356,1,21,219,109,328
357,1,21,11,29,40
358,1,21,87,115,202
359,1,21,62,78,140
360,1,21,103,137,240
361,1,21,25,41,66
362,1,21,157,122,279
363,1,21,26,49,75
364,1,21,119,149,268
365,1,21,161,124,285
366,1,21,108,51,159
367,1,21,179,193,372
368,1,21,21,37,58
369,1,21,76,60,136
370,1,21,8,15,23
371,1,21,94,119,213
372,1,21,69,44,113
373,1,21,36,61,97
374,1,21,104,84,188
375,1,21,56,72,128
376,1,21,198,140,338
377,1,21,266,250,516
378,1,21,56,38,94
379,1,21,70,83,153
380,1,21,106,62,168
381,1,21,14,32,46
382,1,21,65,92,157
383,1,21,48,38,86
384,1,21,152,147,299
385,1,21,20,36,56
386,1,21,120,103,223
387,1,21,35,33,68
388,1,21,46,56,102
389,1,21,0,1,1
390,1,21,549,308,857
391,1,21,16,46,62
392,1,21,20,47,67
393,1,21,170,169,339
394,1,21,47,84,131
395,1,21,98,65,163
396,1,21,51,40,91
397,1,21,10,22,32
398,1,21,55,97,152
399,1,21,34,20,54
400,1,21,21,25,46
401,1,21,14,14,28
402,1,21,23,47,70
403,1,21,60,94,154
404,1,21,5,8,13
405,1,21,312,373,685
406,1,21,96,152,248
407,1,21,17,32,49
408,1,21,152,206,358
409,1,21,39,43,82
410,1,21,99,201,300
411,1,21,170,167,337
412,1,21,1,8,9
413,1,21,19,26,45
414,1,21,11,26,37
415,1,21,25,99,124
416,1,21,113,133,246
417,1,21,12,33,45
418,1,21,93,84,177
419,1,21,123,108,231
420,1,21,252,171,423
421,1,21,182,173,355
422,1,21,81,140,221
423,1,21,5,13,18
424,1,21,1,1,2
